<level levelName="SD_Playtest2_05">
  <grid>
      <cellData width="48" height="40">
			<cellElevations>
              0 0 0 0 0 0 0 0 0 0 0 0 0 0 0 0 0 0 0 0 0 0 0 0 0 0 0 0 0 0 0 0 0 0 0 0 0 0 0 0 0 0 0 0 0 0 0 0 
              0 0 0 0 0 0 0 0 0 0 0 0 0 0 0 0 0 0 0 0 0 0 0 0 0 0 0 0 0 0 0 0 0 0 0 0 0 0 0 0 0 0 0 0 0 0 0 0 
              0 0 0 0 0 0 0 0 0 0 0 0 0 0 0 0 0 0 0 0 0 0 0 0 0 0 0 0 0 0 0 0 0 0 0 0 0 0 0 0 0 0 0 0 0 0 0 0 
              0 0 0 0 0 0 0 0 0 0 0 0 0 0 0 0 0 0 0 0 0 0 0 0 0 0 0 0 0 0 0 0 0 0 0 0 0 0 0 0 0 0 0 0 0 0 0 0 
              0 0 0 0 0 0 0 0 0 0 0 0 0 0 0 0 0 0 0 0 0 0 0 0 0 0 0 0 0 0 0 0 0 0 0 0 0 0 0 0 0 0 0 0 0 0 0 0 
              0 0 0 0 0 0 0 0 0 0 0 0 0 0 0 0 0 0 0 0 0 0 0 0 0 0 0 0 0 0 0 0 0 0 0 0 0 0 0 0 0 0 0 0 0 0 0 0 
              0 0 0 0 0 0 0 0 0 0 0 0 0 0 0 0 0 0 0 0 0 0 0 0 0 0 0 0 0 0 0 0 0 0 0 0 0 0 0 0 0 0 0 0 0 0 0 0 
              0 0 0 0 0 0 0 0 0 0 0 0 0 0 0 0 0 0 0 0 0 0 0 0 0 0 0 0 0 0 0 0 0 0 0 0 0 0 0 0 0 0 0 0 0 0 0 0 
              0 0 0 0 0 0 0 0 0 0 0 0 0 0 0 0 0 0 0 0 0 0 0 0 0 0 0 0 0 0 0 0 0 0 0 0 0 0 0 0 0 0 0 0 0 0 0 0 
              0 0 0 0 0 0 0 0 0 0 0 0 0 0 0 0 0 0 0 0 0 0 0 0 0 0 0 0 0 0 0 0 0 0 0 0 0 0 0 0 0 0 0 0 0 0 0 0 
              0 0 0 0 0 0 0 0 0 0 0 0 0 0 0 0 0 0 0 0 0 0 0 0 0 0 0 0 0 0 0 0 0 0 0 0 0 0 0 0 0 0 0 0 0 0 0 0 
              0 0 0 0 0 0 0 0 0 0 0 0 0 0 0 0 0 0 0 0 0 0 0 0 0 0 0 0 0 0 0 0 0 0 0 0 0 0 0 0 0 0 0 0 0 0 0 0 
              0 0 0 0 0 0 0 0 0 0 0 0 0 0 0 0 0 0 0 0 0 0 0 0 0 0 0 0 0 0 0 0 0 0 0 0 0 0 0 0 0 0 0 0 0 0 0 0 
              0 0 0 0 0 0 0 0 0 0 0 0 0 0 0 0 0 0 0 0 0 0 0 0 0 0 0 0 0 0 0 0 0 0 0 0 0 0 0 0 0 0 0 0 0 0 0 0 
              0 0 0 0 0 0 0 0 0 0 0 0 0 0 0 0 0 0 0 0 0 0 0 0 0 0 0 0 0 0 0 0 0 0 0 0 0 0 0 0 0 0 0 0 0 0 0 0 
              0 0 0 0 0 0 0 0 0 0 0 0 0 0 0 0 0 0 0 0 0 0 0 0 0 0 0 0 0 0 0 0 0 0 0 0 0 0 0 0 0 0 0 0 0 0 0 0 
              0 0 0 0 0 0 0 0 0 0 0 0 0 0 0 0 0 0 0 0 0 0 0 0 0 0 0 0 0 0 0 0 0 0 0 0 0 0 0 0 0 0 0 0 0 0 0 0 
              0 0 0 0 0 0 0 0 0 0 0 0 0 0 0 0 0 0 0 0 0 0 0 0 0 0 0 0 0 0 0 0 0 0 0 0 0 0 0 0 0 0 0 0 0 0 0 0 
              0 0 0 0 0 0 0 0 0 0 0 0 0 0 0 0 0 0 0 0 0 0 0 0 0 0 0 0 0 0 0 0 0 0 0 0 0 0 0 0 0 0 0 0 0 0 0 0 
              0 0 0 0 0 0 0 0 0 0 0 0 0 0 0 0 0 0 0 0 0 0 0 0 0 0 0 0 0 0 0 0 0 0 0 0 0 0 0 0 0 0 0 0 0 0 0 0 
              0 0 0 0 2 2 2 2 2 2 2 2 2 2 2 2 0 0 0 2 2 2 2 2 2 2 2 2 0 0 0 0 0 0 0 0 0 0 0 0 0 0 0 0 0 0 0 0 
              0 0 0 0 2 2 2 2 2 2 2 2 2 2 2 2 0 0 0 2 2 2 2 2 2 2 2 2 0 0 0 0 0 0 0 0 0 0 0 0 0 0 0 0 0 0 0 0 
              0 0 0 0 2 2 2 2 2 2 2 2 2 2 2 2 0 0 0 2 2 2 2 2 2 2 2 2 0 0 0 0 0 0 0 0 0 0 0 0 0 0 0 0 0 0 0 0 
              0 0 0 0 2 2 2 0 0 0 0 0 0 0 0 2 0 0 0 2 2 2 2 2 2 2 2 2 0 0 0 0 0 0 0 0 0 0 0 0 0 0 0 0 0 0 0 0 
              0 0 0 0 2 2 2 1 1 1 0 0 0 0 0 0 0 0 0 2 2 2 2 2 2 2 2 2 0 0 0 0 0 0 0 0 0 0 0 0 0 0 0 0 0 0 0 0 
              0 0 0 0 2 2 2 1 1 1 0 0 0 0 0 0 0 0 0 2 2 2 2 2 2 2 2 2 0 0 0 0 0 0 0 0 0 0 0 0 0 0 0 0 0 0 0 0 
              0 0 0 0 2 2 2 1 1 1 0 0 0 0 0 0 0 0 0 0 0 0 2 2 2 2 2 2 0 0 0 0 0 0 0 0 0 0 0 0 0 0 0 0 0 0 0 0 
              0 0 0 0 2 2 2 1 1 1 0 0 0 0 0 0 0 0 0 0 0 0 2 2 2 2 2 2 0 0 0 0 0 0 0 0 0 0 0 0 0 0 0 0 0 0 0 0 
              0 0 0 0 2 2 2 1 1 1 0 0 0 0 0 0 0 0 0 0 0 0 2 2 2 2 2 2 0 0 0 0 0 0 0 0 0 0 0 0 0 0 0 0 0 0 0 0 
              0 0 0 0 2 2 2 1 1 1 0 0 0 0 0 0 0 0 0 0 0 0 2 2 2 2 2 2 0 0 0 0 0 0 0 0 0 0 0 0 0 0 0 0 0 0 0 0 
              0 0 0 0 2 2 2 0 0 0 0 0 0 0 0 0 0 0 0 0 0 0 2 2 2 2 2 2 0 0 0 0 0 0 0 0 0 0 0 0 0 0 0 0 0 0 0 0 
              0 0 0 0 2 2 2 0 0 0 0 0 0 0 2 0 2 0 2 0 2 0 2 2 2 2 2 2 0 0 0 0 0 0 0 0 0 0 0 0 0 0 0 0 0 0 0 0 
              0 0 0 0 1 0 0 0 0 0 0 0 0 0 0 0 0 0 0 0 0 0 0 0 0 2 2 2 0 0 0 0 0 0 0 0 0 0 0 0 0 0 0 0 0 0 0 0 
              0 0 0 0 1 0 0 0 0 0 0 0 0 0 0 0 0 0 0 0 0 0 0 0 0 2 2 2 0 0 0 0 0 0 0 0 0 0 0 0 0 0 0 0 0 0 0 0 
              0 0 0 0 1 0 0 0 0 0 0 0 0 0 0 0 0 0 0 0 0 0 0 0 0 2 2 2 0 0 0 0 0 0 0 0 0 0 0 0 0 0 0 0 0 0 0 0 
              0 0 0 0 1 1 1 1 1 1 1 1 1 0 0 0 1 1 1 1 1 1 1 1 1 2 2 2 0 0 0 0 0 0 0 0 0 0 0 0 0 0 0 0 0 0 0 0 
              0 0 0 0 1 1 1 1 1 1 1 1 1 0 0 0 1 1 1 1 1 1 1 1 1 2 2 2 0 0 0 0 0 0 0 0 0 0 0 0 0 0 0 0 0 0 0 0 
              0 0 0 0 1 1 1 1 1 1 1 1 1 1 1 1 1 1 1 1 1 1 1 1 1 2 2 2 0 0 0 0 0 0 0 0 0 0 0 0 0 0 0 0 0 0 0 0 
              0 0 0 0 0 0 0 0 0 0 0 0 0 0 0 0 0 0 0 0 0 0 0 0 0 0 0 0 0 0 0 0 0 0 0 0 0 0 0 0 0 0 0 0 0 0 0 0 
              0 0 0 0 0 0 0 0 0 0 0 0 0 0 0 0 0 0 0 0 0 0 0 0 0 0 0 0 0 0 0 0 0 0 0 0 0 0 0 0 0 0 0 0 0 0 0 0 
			</cellElevations>

			<passableCells>
              0 0 0 0 0 0 0 0 0 0 0 0 0 0 0 0 0 0 0 0 0 0 0 0 0 0 0 0 0 0 0 0 0 0 0 0 0 0 0 0 0 0 0 0 0 0 0 0 
              0 0 0 0 0 0 0 0 0 0 0 0 0 0 0 0 0 0 0 0 0 0 0 0 0 0 0 0 0 0 0 0 0 0 0 0 0 0 0 0 0 0 0 0 0 0 0 0 
              0 0 0 0 0 0 0 0 0 0 0 0 0 0 0 0 0 0 0 0 0 0 0 0 0 0 0 0 0 0 0 0 0 0 0 0 0 0 0 0 0 0 0 0 0 0 0 0 
              0 0 0 0 0 0 0 0 0 0 0 0 0 0 0 0 0 0 0 0 0 0 0 0 0 0 0 0 0 0 0 0 0 0 0 0 0 0 0 0 0 0 0 0 0 0 0 0 
              0 0 0 0 0 0 0 0 0 0 0 0 0 0 0 0 0 0 0 0 0 0 0 0 0 0 0 0 0 0 0 0 0 0 0 0 0 0 0 0 0 0 0 0 0 0 0 0 
              0 0 0 0 0 0 0 0 0 0 0 0 0 0 0 0 0 0 0 0 0 0 0 0 0 0 0 0 0 0 0 0 0 0 0 0 0 0 0 0 0 0 0 0 0 0 0 0 
              0 0 0 0 0 0 0 0 0 0 0 0 0 0 0 0 0 0 0 0 0 0 0 0 0 0 0 0 0 0 0 0 0 0 0 0 0 0 0 0 0 0 0 0 0 0 0 0 
              0 0 0 0 0 0 0 0 0 0 0 0 0 0 0 0 0 0 0 0 0 0 0 0 0 0 0 0 0 0 0 0 0 0 0 0 0 0 0 0 0 0 0 0 0 0 0 0 
              0 0 0 0 0 0 0 0 0 0 0 0 0 0 0 0 0 0 0 0 0 0 0 0 0 0 0 0 0 0 0 0 0 0 0 0 0 0 0 0 0 0 0 0 0 0 0 0 
              0 0 0 0 0 0 0 0 0 0 0 0 0 0 0 0 0 0 0 0 0 0 0 0 0 0 0 0 0 0 0 0 0 0 0 0 0 0 0 0 0 0 0 0 0 0 0 0 
              0 0 0 0 0 0 0 0 0 0 0 0 0 0 0 0 0 0 0 0 0 0 0 0 0 0 0 0 0 0 0 0 0 0 0 0 0 0 0 0 0 0 0 0 0 0 0 0 
              0 0 0 0 0 0 0 0 0 0 0 0 0 0 0 0 0 0 0 0 0 0 0 0 0 0 0 0 0 0 0 0 0 0 0 0 0 0 0 0 0 0 0 0 0 0 0 0 
              0 0 0 0 0 0 0 0 0 0 0 0 0 0 0 0 0 0 0 0 0 0 0 0 0 0 0 0 0 0 0 0 0 0 0 0 0 0 0 0 0 0 0 0 0 0 0 0 
              0 0 0 0 0 0 0 0 0 0 0 0 0 0 0 0 0 0 0 0 0 0 0 0 0 0 0 0 0 0 0 0 0 0 0 0 0 0 0 0 0 0 0 0 0 0 0 0 
              0 0 0 0 0 0 0 0 0 0 0 0 0 0 0 0 0 0 0 0 0 0 0 0 0 0 0 0 0 0 0 0 0 0 0 0 0 0 0 0 0 0 0 0 0 0 0 0 
              0 0 0 0 0 0 0 0 0 0 0 0 0 0 0 0 0 0 0 0 0 0 0 0 0 0 0 0 0 0 0 0 0 0 0 0 0 0 0 0 0 0 0 0 0 0 0 0 
              0 0 0 0 0 0 0 0 0 0 0 0 0 0 0 0 0 0 0 0 0 0 0 0 0 0 0 0 0 0 0 0 0 0 0 0 0 0 0 0 0 0 0 0 0 0 0 0 
              0 0 0 0 0 0 0 0 0 0 0 0 0 0 0 0 0 0 0 0 0 0 0 0 0 0 0 0 0 0 0 0 0 0 0 0 0 0 0 0 0 0 0 0 0 0 0 0 
              0 0 0 0 0 0 0 0 0 0 0 0 0 0 0 0 1 1 1 0 0 0 0 0 0 0 0 0 0 0 0 0 0 0 0 0 0 0 0 0 0 0 0 0 0 0 0 0 
              0 0 0 0 0 0 0 0 0 0 0 0 0 0 0 0 1 1 1 0 0 0 0 0 0 0 0 0 0 0 0 0 0 0 0 0 0 0 0 0 0 0 0 0 0 0 0 0 
              0 0 0 0 0 0 0 0 0 0 0 0 0 0 0 0 1 1 1 0 0 0 0 0 0 0 0 0 0 0 0 0 0 0 0 0 0 0 0 0 0 0 0 0 0 0 0 0 
              0 0 0 0 0 0 0 0 0 0 0 0 0 0 0 0 1 1 1 0 0 0 0 0 0 0 0 0 0 0 0 0 0 0 0 0 0 0 0 0 0 0 0 0 0 0 0 0 
              0 0 0 0 0 0 0 0 0 0 0 0 0 0 0 0 1 1 1 0 0 0 0 0 0 0 0 0 0 0 0 0 0 0 0 0 0 0 0 0 0 0 0 0 0 0 0 0 
              0 0 0 0 0 0 0 0 0 0 1 1 1 1 1 0 1 1 1 1 1 1 1 1 1 0 0 0 0 0 0 0 0 0 0 0 0 0 0 0 0 0 0 0 0 0 0 0 
              0 0 0 0 0 0 0 0 0 0 1 1 1 1 1 1 1 1 1 1 1 1 1 1 1 0 0 0 0 0 0 0 0 0 0 0 0 0 0 0 0 0 0 0 0 0 0 0 
              0 0 0 0 0 0 0 0 0 0 1 1 1 1 1 1 1 1 1 1 1 1 1 1 1 0 0 0 0 0 0 0 0 0 0 0 0 0 0 0 0 0 0 0 0 0 0 0 
              0 0 0 0 0 0 0 0 0 0 1 1 1 1 1 1 1 1 1 1 1 1 1 1 1 0 0 0 0 0 0 0 0 0 0 0 0 0 0 0 0 0 0 0 0 0 0 0 
              0 0 0 0 0 0 0 0 0 0 0 0 0 0 0 0 1 1 1 0 0 0 1 1 1 0 0 0 0 0 0 0 0 0 0 0 0 0 0 0 0 0 0 0 0 0 0 0 
              0 0 0 0 0 0 0 0 0 0 0 0 0 0 0 0 1 1 1 0 0 0 1 1 1 0 0 0 0 0 0 0 0 0 0 0 0 0 0 0 0 0 0 0 0 0 0 0 
              0 0 0 0 0 0 0 0 0 0 0 0 0 0 0 0 0 1 0 0 0 0 1 1 1 0 0 0 0 0 0 0 0 0 0 0 0 0 0 0 0 0 0 0 0 0 0 0 
              0 0 0 0 0 0 0 1 1 1 1 1 1 1 0 1 0 1 0 1 0 1 1 1 1 0 0 0 0 0 0 0 0 0 0 0 0 0 0 0 0 0 0 0 0 0 0 0 
              0 0 0 0 0 0 0 1 1 1 1 1 1 1 1 1 1 1 1 1 1 1 1 1 1 0 0 0 0 0 0 0 0 0 0 0 0 0 0 0 0 0 0 0 0 0 0 0 
              0 0 0 0 0 1 1 1 1 1 1 1 1 1 1 1 1 1 1 1 1 1 1 1 1 0 0 0 0 0 0 0 0 0 0 0 0 0 0 0 0 0 0 0 0 0 0 0 
              0 0 0 0 0 1 1 1 1 1 1 1 1 1 1 1 1 1 1 1 1 1 1 1 1 0 0 0 0 0 0 0 0 0 0 0 0 0 0 0 0 0 0 0 0 0 0 0 
              0 0 0 0 0 0 0 0 0 0 0 0 0 1 1 1 0 0 0 0 0 0 0 0 0 0 0 0 0 0 0 0 0 0 0 0 0 0 0 0 0 0 0 0 0 0 0 0 
              0 0 0 0 0 0 0 0 0 0 0 0 0 1 1 1 0 0 0 0 0 0 0 0 0 0 0 0 0 0 0 0 0 0 0 0 0 0 0 0 0 0 0 0 0 0 0 0 
              0 0 0 0 0 0 0 0 0 0 0 0 0 1 1 1 0 0 0 0 0 0 0 0 0 0 0 0 0 0 0 0 0 0 0 0 0 0 0 0 0 0 0 0 0 0 0 0 
              0 0 0 0 0 0 0 0 0 0 0 0 0 0 0 0 0 0 0 0 0 0 0 0 0 0 0 0 0 0 0 0 0 0 0 0 0 0 0 0 0 0 0 0 0 0 0 0 
              0 0 0 0 0 0 0 0 0 0 0 0 0 1 1 1 0 0 0 0 0 0 0 0 0 0 0 0 0 0 0 0 0 0 0 0 0 0 0 0 0 0 0 0 0 0 0 0 
              0 0 0 0 0 0 0 0 0 0 0 0 0 0 0 0 0 0 0 0 0 0 0 0 0 0 0 0 0 0 0 0 0 0 0 0 0 0 0 0 0 0 0 0 0 0 0 0 
			</passableCells>

			<visibleCells>
              1 1 1 1 1 1 1 1 1 1 1 1 1 1 1 1 1 1 1 1 1 1 1 1 1 1 1 1 1 1 1 1 1 1 1 1 1 1 1 1 1 1 1 1 1 1 1 1 
              1 1 1 1 1 1 1 1 1 1 1 1 1 1 1 1 1 1 1 1 1 1 1 1 1 1 1 1 1 1 1 1 1 1 1 1 1 1 1 1 1 1 1 1 1 1 1 1 
              1 1 1 1 1 1 1 1 1 1 1 1 1 1 1 1 1 1 1 1 1 1 1 1 1 1 1 1 1 1 1 1 1 1 1 1 1 1 1 1 1 1 1 1 1 1 1 1 
              1 1 1 1 1 1 1 1 1 1 1 1 1 1 1 1 1 1 1 1 1 1 1 1 1 1 1 1 1 1 1 1 1 1 1 1 1 1 1 1 1 1 1 1 1 1 1 1 
              1 1 1 1 1 1 1 1 1 1 1 1 1 1 1 1 1 1 1 1 1 1 1 1 1 1 1 1 1 1 1 1 1 1 1 1 1 1 1 1 1 1 1 1 1 1 1 1 
              1 1 1 1 1 1 1 1 1 1 1 1 1 1 1 1 1 1 1 1 1 1 1 1 1 1 1 1 1 1 1 1 1 1 1 1 1 1 1 1 1 1 1 1 1 1 1 1 
              1 1 1 1 1 1 1 1 1 1 1 1 1 1 1 1 1 1 1 1 1 1 1 1 1 1 1 1 1 1 1 1 1 1 1 1 1 1 1 1 1 1 1 1 1 1 1 1 
              1 1 1 1 1 1 1 1 1 1 1 1 1 1 1 1 1 1 1 1 1 1 1 1 1 1 1 1 1 1 1 1 1 1 1 1 1 1 1 1 1 1 1 1 1 1 1 1 
              1 1 1 1 1 1 1 1 1 1 1 1 1 1 1 1 1 1 1 1 1 1 1 1 1 1 1 1 1 1 1 1 1 1 1 1 1 1 1 1 1 1 1 1 1 1 1 1 
              1 1 1 1 1 1 1 1 1 1 1 1 1 1 1 1 1 1 1 1 1 1 1 1 1 1 1 1 1 1 1 1 1 1 1 1 1 1 1 1 1 1 1 1 1 1 1 1 
              1 1 1 1 1 1 1 1 1 1 1 1 1 1 1 1 1 1 1 1 1 1 1 1 1 1 1 1 1 1 1 1 1 1 1 1 1 1 1 1 1 1 1 1 1 1 1 1 
              1 1 1 1 1 1 1 1 1 1 1 1 1 1 1 1 1 1 1 1 1 1 1 1 1 1 1 1 1 1 1 1 1 1 1 1 1 1 1 1 1 1 1 1 1 1 1 1 
              1 1 1 1 1 1 1 1 1 1 1 1 1 1 1 1 1 1 1 1 1 1 1 1 1 1 1 1 1 1 1 1 1 1 1 1 1 1 1 1 1 1 1 1 1 1 1 1 
              1 1 1 1 1 1 1 1 1 1 1 1 1 1 1 1 1 1 1 1 1 1 1 1 1 1 1 1 1 1 1 1 1 1 1 1 1 1 1 1 1 1 1 1 1 1 1 1 
              1 1 1 1 1 1 1 1 1 1 1 1 1 1 1 1 1 1 1 1 1 1 1 1 1 1 1 1 1 1 1 1 1 1 1 1 1 1 1 1 1 1 1 1 1 1 1 1 
              1 1 1 1 1 1 1 1 1 1 1 1 1 1 1 1 1 1 1 1 1 1 1 1 1 1 1 1 1 1 1 1 1 1 1 1 1 1 1 1 1 1 1 1 1 1 1 1 
              1 1 1 1 1 1 1 1 1 1 1 1 1 1 1 1 1 1 1 1 1 1 1 1 1 1 1 1 1 1 1 1 1 1 1 1 1 1 1 1 1 1 1 1 1 1 1 1 
              1 1 1 1 0 0 0 0 0 0 0 0 0 0 0 0 1 1 1 0 0 0 0 0 0 0 0 0 1 1 1 1 1 1 1 1 1 1 1 1 1 1 1 1 1 1 1 1 
              1 1 1 1 0 0 0 0 0 0 0 0 0 0 0 0 1 1 1 0 0 0 0 0 0 0 0 0 1 1 1 1 1 1 1 1 1 1 1 1 1 1 1 1 1 1 1 1 
              1 1 1 1 0 0 0 0 0 0 0 0 0 0 0 0 1 1 1 0 0 0 0 0 0 0 0 0 1 1 1 1 1 1 1 1 1 1 1 1 1 1 1 1 1 1 1 1 
              1 1 1 1 0 0 0 0 0 0 0 0 0 0 0 0 1 1 1 0 0 0 0 0 0 0 0 0 1 1 1 1 1 1 1 1 1 1 1 1 1 1 1 1 1 1 1 1 
              1 1 1 1 0 0 0 0 0 0 0 0 0 0 0 0 1 1 1 0 0 0 0 0 0 0 0 0 1 1 1 1 1 1 1 1 1 1 1 1 1 1 1 1 1 1 1 1 
              1 1 1 1 0 0 0 0 0 0 0 0 0 0 0 0 1 1 1 0 0 0 0 0 0 0 0 0 1 1 1 1 1 1 1 1 1 1 1 1 1 1 1 1 1 1 1 1 
              1 1 1 1 0 0 0 0 0 0 1 1 1 1 1 1 1 1 1 1 1 1 1 1 1 0 0 0 1 1 1 1 1 1 1 1 1 1 1 1 1 1 1 1 1 1 1 1 
              1 1 1 1 0 0 0 1 1 1 1 1 1 1 1 1 1 1 1 1 1 1 1 1 1 0 0 0 1 1 1 1 1 1 1 1 1 1 1 1 1 1 1 1 1 1 1 1 
              1 1 1 1 0 0 0 1 1 1 1 1 1 1 1 1 1 1 1 1 1 1 1 1 1 0 0 0 1 1 1 1 1 1 1 1 1 1 1 1 1 1 1 1 1 1 1 1 
              1 1 1 1 0 0 0 1 1 1 1 1 1 1 1 1 1 1 1 1 1 1 1 1 1 0 0 0 1 1 1 1 1 1 1 1 1 1 1 1 1 1 1 1 1 1 1 1 
              1 1 1 1 0 0 0 1 1 1 1 1 1 1 1 1 1 1 1 1 1 1 1 1 1 0 0 0 1 1 1 1 1 1 1 1 1 1 1 1 1 1 1 1 1 1 1 1 
              1 1 1 1 0 0 0 1 1 1 1 1 1 1 1 1 1 1 1 1 1 1 1 1 1 0 0 0 1 1 1 1 1 1 1 1 1 1 1 1 1 1 1 1 1 1 1 1 
              1 1 1 1 0 0 0 1 1 1 1 1 1 1 0 1 0 1 0 1 0 1 1 1 1 0 0 0 1 1 1 1 1 1 1 1 1 1 1 1 1 1 1 1 1 1 1 1 
              1 1 1 1 0 0 0 1 1 1 1 1 1 1 0 1 0 1 0 1 0 1 1 1 1 0 0 0 1 1 1 1 1 1 1 1 1 1 1 1 1 1 1 1 1 1 1 1 
              1 1 1 1 0 0 0 1 1 1 1 1 1 1 1 1 1 1 1 1 1 1 1 1 1 0 0 0 1 1 1 1 1 1 1 1 1 1 1 1 1 1 1 1 1 1 1 1 
              1 1 1 1 1 1 1 1 1 1 1 1 1 1 1 1 1 1 1 1 1 1 1 1 1 0 0 0 1 1 1 1 1 1 1 1 1 1 1 1 1 1 1 1 1 1 1 1 
              1 1 1 1 1 1 1 1 1 1 1 1 1 1 1 1 1 1 1 1 1 1 1 1 1 0 0 0 1 1 1 1 1 1 1 1 1 1 1 1 1 1 1 1 1 1 1 1 
              1 1 1 1 1 0 0 0 0 0 0 0 0 1 1 1 0 0 0 0 0 0 0 0 0 0 0 0 1 1 1 1 1 1 1 1 1 1 1 1 1 1 1 1 1 1 1 1 
              1 1 1 1 1 1 1 1 1 1 1 1 1 1 1 1 1 1 1 1 1 1 1 1 1 0 0 0 1 1 1 1 1 1 1 1 1 1 1 1 1 1 1 1 1 1 1 1 
              1 1 1 1 1 1 1 1 1 1 1 1 1 1 1 1 1 1 1 1 1 1 1 1 1 0 0 0 1 1 1 1 1 1 1 1 1 1 1 1 1 1 1 1 1 1 1 1 
              1 1 1 1 1 1 1 1 1 1 1 1 1 1 1 1 1 1 1 1 1 1 1 1 1 0 0 0 1 1 1 1 1 1 1 1 1 1 1 1 1 1 1 1 1 1 1 1 
              1 1 1 1 1 1 1 1 1 1 1 1 1 1 1 1 1 1 1 1 1 1 1 1 1 1 1 1 1 1 1 1 1 1 1 1 1 1 1 1 1 1 1 1 1 1 1 1 
              1 1 1 1 1 1 1 1 1 1 1 1 1 1 1 1 1 1 1 1 1 1 1 1 1 1 1 1 1 1 1 1 1 1 1 1 1 1 1 1 1 1 1 1 1 1 1 1 
			</visibleCells>
      </cellData>

      <roomData>
          <room x="9" z="7" width="17" height="11">
          </room>
      </roomData>
  </grid>

  <static>
		<staticObject id="173140" prefab="SD_Column_01" x="15" y="0.0" z="16" width="1" height="1" rotation="180">
      </staticObject>
		<staticObject id="172762" prefab="SD_Hedge_Straight_01" x="4" y="0.0" z="7" width="1" height="1" rotation="180">
      </staticObject>
		<staticObject id="171662" prefab="SD_Hedge_Straight_01" x="13" y="0.0" z="2" width="1" height="1" rotation="90">
      </staticObject>
		<staticObject id="173902" prefab="SD_Hedge_Straight_01" x="4" y="0.0" z="5" width="1" height="1" rotation="180">
      </staticObject>
		<staticObject id="173394" prefab="SD_Hedge_Straight_01" x="15" y="0.0" z="2" width="1" height="1" rotation="90">
      </staticObject>
		<staticObject id="174478" prefab="SD_Hedge_Straight_01" x="4" y="0.0" z="6" width="1" height="1" rotation="180">
      </staticObject>
		<staticObject id="174104" prefab="SD_Hedge_Straight_01" x="14" y="0.0" z="2" width="1" height="1" rotation="90">
      </staticObject>
		<staticObject id="172820" prefab="SD_MedWall_Standalone_01" x="18" y="0.0" z="8" width="1" height="1" rotation="180">
      </staticObject>
		<staticObject id="173098" prefab="SD_MedWall_Standalone_01" x="20" y="0.0" z="8" width="1" height="1" rotation="180">
      </staticObject>
		<staticObject id="173854" prefab="SD_MedWall_Standalone_01" x="14" y="0.0" z="8" width="1" height="1" rotation="180">
      </staticObject>
		<staticObject id="173354" prefab="SD_MedWall_Standalone_01" x="16" y="0.0" z="8" width="1" height="1" rotation="180">
      </staticObject>
		<staticObject id="172160" prefab="SD_Short_House_End_01" x="7" y="0.0" z="13" width="3" height="3" rotation="270">
      </staticObject>
		<staticObject id="172292" prefab="SD_Short_House_End_01" x="7" y="0.0" z="10" width="3" height="3" rotation="90">
      </staticObject>
		<staticObject id="174364" prefab="SD_Short_House_End_01" x="4" y="0.0" z="2" width="3" height="3" rotation="0">
      </staticObject>
		<staticObject id="171898" prefab="SD_Short_House_End_01" x="10" y="0.0" z="2" width="3" height="3" rotation="180">
      </staticObject>
		<staticObject id="171976" prefab="SD_Short_House_End_01" x="16" y="0.0" z="2" width="3" height="3" rotation="0">
      </staticObject>
		<staticObject id="173044" prefab="SD_Short_House_Straight_01" x="22" y="0.0" z="2" width="3" height="3" rotation="180">
      </staticObject>
		<staticObject id="171910" prefab="SD_Short_House_Straight_01" x="19" y="0.0" z="2" width="3" height="3" rotation="180">
      </staticObject>
		<staticObject id="172676" prefab="SD_Short_House_Straight_01" x="7" y="0.0" z="2" width="3" height="3" rotation="180">
      </staticObject>
		<staticObject id="172842" prefab="SD_Tall_House_Corner_01" x="25" y="0.0" z="17" width="3" height="3" rotation="0">
      </staticObject>
		<staticObject id="172880" prefab="SD_Tall_House_Corner_01" x="4" y="0.0" z="17" width="3" height="3" rotation="90">
      </staticObject>
		<staticObject id="173240" prefab="SD_Tall_House_End_01" x="25" y="0.0" z="2" width="3" height="3" rotation="90">
      </staticObject>
		<staticObject id="172558" prefab="SD_Tall_House_End_01" x="4" y="0.0" z="8" width="3" height="3" rotation="90">
      </staticObject>
		<staticObject id="174482" prefab="SD_Tall_House_End_01" x="13" y="0.0" z="17" width="3" height="3" rotation="180">
      </staticObject>
		<staticObject id="174268" prefab="SD_Tall_House_End_01" x="19" y="0.0" z="17" width="3" height="3" rotation="0">
      </staticObject>
		<staticObject id="173664" prefab="SD_Tall_House_Straight_01" x="25" y="0.0" z="8" width="3" height="3" rotation="90">
      </staticObject>
		<staticObject id="172598" prefab="SD_Tall_House_Straight_01" x="25" y="0.0" z="11" width="3" height="3" rotation="90">
      </staticObject>
		<staticObject id="174156" prefab="SD_Tall_House_Straight_01" x="25" y="0.0" z="14" width="3" height="3" rotation="90">
      </staticObject>
		<staticObject id="172682" prefab="SD_Tall_House_Straight_01" x="4" y="0.0" z="11" width="3" height="3" rotation="90">
      </staticObject>
		<staticObject id="171928" prefab="SD_Tall_House_Straight_01" x="7" y="0.0" z="17" width="3" height="3" rotation="180">
      </staticObject>
		<staticObject id="171818" prefab="SD_Tall_House_Straight_01" x="22" y="0.0" z="17" width="3" height="3" rotation="180">
      </staticObject>
		<staticObject id="172266" prefab="SD_Tall_House_Straight_01" x="25" y="0.0" z="5" width="3" height="3" rotation="90">
      </staticObject>
		<staticObject id="173148" prefab="SD_Tall_House_Straight_01" x="10" y="0.0" z="17" width="3" height="3" rotation="180">
      </staticObject>
		<staticObject id="173214" prefab="SD_Tall_House_Straight_01" x="4" y="0.0" z="14" width="3" height="3" rotation="90">
      </staticObject>
		<staticObject id="172824" prefab="SD_Tall_Terrace_End_01" x="22" y="0.0" z="8" width="3" height="3" rotation="90">
      </staticObject>
		<staticObject id="173144" prefab="SD_Tall_Terrace_End_01" x="19" y="0.0" z="14" width="3" height="3" rotation="0">
      </staticObject>
		<staticObject id="174464" prefab="SD_Tall_Terrace_Straight_01" x="22" y="0.0" z="14" width="3" height="3" rotation="90">
      </staticObject>
		<staticObject id="173522" prefab="SD_Tall_Terrace_Straight_01" x="22" y="0.0" z="11" width="3" height="3" rotation="90">
      </staticObject>
		<staticObject id="174286" prefab="SD_Chasm_1x3_01" x="19" y="0.0" z="10" width="3" height="1" rotation="0">
      </staticObject>
		<staticObject id="171894" prefab="SD_Chasm_1x3_01" x="19" y="0.0" z="12" width="3" height="1" rotation="180">
      </staticObject>
		<staticObject id="171906" prefab="SD_Chasm_1x3_01" x="10" y="0.0" z="10" width="1" height="3" rotation="270">
      </staticObject>
		<staticObject id="172368" prefab="SD_Chasm_1x3_01" x="21" y="0.0" z="10" width="1" height="3" rotation="90">
      </staticObject>
		<staticObject id="173532" prefab="SD_Chasm_1x9_01" x="10" y="0.0" z="10" width="9" height="1" rotation="0">
      </staticObject>
		<staticObject id="171864" prefab="SD_Chasm_1x9_01" x="7" y="0.0" z="12" width="9" height="1" rotation="180">
      </staticObject>
		<staticObject id="173230" prefab="SD_Floor_Grass_1x2_01" x="25" y="0.0" z="7" width="1" height="2" rotation="90">
      </staticObject>
		<staticObject id="174608" prefab="SD_Floor_Grass_1x3_01" x="19" y="0.0" z="13" width="3" height="1" rotation="180">
      </staticObject>
		<staticObject id="174150" prefab="SD_Floor_Grass_1x5_01" x="20" y="0.0" z="8" width="5" height="1" rotation="180">
      </staticObject>
		<staticObject id="171706" prefab="SD_Floor_Grass_1x5_01" x="15" y="0.0" z="13" width="1" height="5" rotation="90">
      </staticObject>
		<staticObject id="172224" prefab="SD_Floor_Grass_1x5_01" x="14" y="0.0" z="13" width="1" height="5" rotation="90">
      </staticObject>
		<staticObject id="174146" prefab="SD_Floor_Grass_1x5_01" x="20" y="0.0" z="7" width="5" height="1" rotation="180">
      </staticObject>
		<staticObject id="172000" prefab="SD_Floor_Grass_5x5_01" x="9" y="0.0" z="13" width="5" height="5" rotation="180">
      </staticObject>
		<staticObject id="173696" prefab="SD_Floor_Stone_1x2_01" x="19" y="0.0" z="7" width="1" height="2" rotation="90">
      </staticObject>
		<staticObject id="173120" prefab="SD_Floor_Stone_1x3_01" x="4" y="0.0" z="7" width="3" height="1" rotation="180">
      </staticObject>
		<staticObject id="173816" prefab="SD_Floor_Stone_1x3_01" x="19" y="0.0" z="9" width="3" height="1" rotation="180">
      </staticObject>
		<staticObject id="173224" prefab="SD_Floor_Stone_1x9_01" x="4" y="0.0" z="6" width="9" height="1" rotation="180">
      </staticObject>
		<staticObject id="172550" prefab="SD_Floor_Stone_1x9_01" x="16" y="0.0" z="6" width="9" height="1" rotation="180">
      </staticObject>
		<staticObject id="173418" prefab="SD_Floor_Stone_1x9_01" x="16" y="0.0" z="5" width="9" height="1" rotation="180">
      </staticObject>
		<staticObject id="174506" prefab="SD_Floor_Stone_1x9_01" x="4" y="0.0" z="5" width="9" height="1" rotation="180">
      </staticObject>
		<staticObject id="173506" prefab="SD_Floor_Stone_3x3_01" x="16" y="0.0" z="13" width="3" height="3" rotation="180">
      </staticObject>
		<staticObject id="173872" prefab="SD_Floor_Stone_3x3_01" x="16" y="0.0" z="7" width="3" height="3" rotation="180">
      </staticObject>
		<staticObject id="171914" prefab="SD_Floor_Stone_3x3_01" x="13" y="0.0" z="7" width="3" height="3" rotation="180">
      </staticObject>
		<staticObject id="172746" prefab="SD_Floor_Stone_3x3_01" x="13" y="0.0" z="4" width="3" height="3" rotation="180">
      </staticObject>
		<staticObject id="172554" prefab="SD_Floor_Stone_3x3_01" x="13" y="0.0" z="1" width="3" height="3" rotation="180">
      </staticObject>
		<staticObject id="173210" prefab="SD_Floor_Stone_3x3_01" x="7" y="0.0" z="7" width="3" height="3" rotation="180">
      </staticObject>
		<staticObject id="174208" prefab="SD_Floor_Stone_3x3_01" x="16" y="0.0" z="19" width="3" height="3" rotation="180">
      </staticObject>
		<staticObject id="173536" prefab="SD_Floor_Stone_3x3_01" x="16" y="0.0" z="16" width="3" height="3" rotation="180">
      </staticObject>
	</static>

  <units>
		<playerUnit id="172948" prefab="Assassin" x="19" z="7" rotation="180">
      </playerUnit>
		<playerUnit id="174510" prefab="Thief" x="15" z="7" rotation="180">
      </playerUnit>
  </units>

  <other>
      <dynamicObject id="171782" prefab="GoalZone_Assassin" x="17" y="0" z="17" rotation="180">
      </dynamicObject>
      <dynamicObject id="172774" prefab="GoalZone_Thief" x="17" y="0" z="17" rotation="180">
      </dynamicObject>
      <dynamicObject id="173402" prefab="PressurePlate" x="10" y="0" z="8" rotation="180">
          <component name="Triggerable">
              <property name="SetDecalType">
                  <field>decal_1.png</field>
              </property>
          </component>
      </dynamicObject>
      <dynamicObject id="172536" prefab="PressurePlate" x="12" y="0" z="8" rotation="180">
          <component name="Triggerable">
              <property name="SetDecalType">
                  <field>decal_1.png</field>
              </property>
          </component>
      </dynamicObject>
      <dynamicObject id="172070" prefab="SD_Interactive_Elevator_01" x="11" y="0" z="8" rotation="90">
          <component name="Triggerable">
              <property name="SetDecalType">
                  <field>decal_1.png</field>
              </property>
          </component>
          <component name="TriggerElevationChange">
              <property name="SetElevationDiff">
                  <field>1</field>
              </property>
          </component>
      </dynamicObject>
      <dynamicObject id="173464" prefab="SD_Interactive_Elevator_01" x="17" y="-0.22" z="11" rotation="180">
          <component name="Triggerable">
              <property name="SetDecalType">
                  <field>decal_2.png</field>
              </property>
          </component>
          <component name="TriggerElevationChange">
              <property name="SetElevationDiff">
                  <field>1</field>
              </property>
          </component>
      </dynamicObject>
      <dynamicObject id="174250" prefab="SD_KeyPad_01" x="20" y="4" z="15" rotation="180">
          <component name="Triggerable">
              <property name="SetDecalType">
                  <field>decal_2.png</field>
              </property>
          </component>
      </dynamicObject>
  </other>

  <links>
      <triggerLink id="172070">
          <switch id="172536">
          </switch>
          <switch id="173402">
          </switch>
      </triggerLink>
      <triggerLink id="173464">
          <switch id="174250">
          </switch>
      </triggerLink>
      <winCondition id="171782">
      </winCondition>
      <winCondition id="172774">
      </winCondition>
  </links>

	<camera focus="Assassin">
      <start x="18" y="26" z="-12.5">
      </start>
      <overview x="15.97837" y="59.97374" z="-13.16934">
      </overview>
	</camera>

	<lightMap name="SD_Playtest2_05_lightmap.png">
	</lightMap>
</level>
