<level levelName="SD_Playtest2_05">
  <grid>
      <cellData width="48" height="40">
			<cellElevations>
              0 0 0 0 0 0 0 0 0 0 0 0 0 0 0 0 0 0 0 0 0 0 0 0 0 0 0 0 0 0 0 0 0 0 0 0 0 0 0 0 0 0 0 0 0 0 0 0 
              0 0 0 0 0 0 0 0 0 0 0 0 0 0 0 0 0 0 0 0 0 0 0 0 0 0 0 0 0 0 0 0 0 0 0 0 0 0 0 0 0 0 0 0 0 0 0 0 
              0 0 0 0 0 0 0 0 0 0 0 0 0 0 0 0 0 0 0 0 0 0 0 0 0 0 0 0 0 0 0 0 0 0 0 0 0 0 0 0 0 0 0 0 0 0 0 0 
              0 0 0 0 0 0 0 0 0 0 0 0 0 0 0 0 0 0 0 0 0 0 0 0 0 0 0 0 0 0 0 0 0 0 0 0 0 0 0 0 0 0 0 0 0 0 0 0 
              0 0 0 0 0 0 0 0 0 0 0 0 0 0 0 0 0 0 0 0 0 0 0 0 0 0 0 0 0 0 0 0 0 0 0 0 0 0 0 0 0 0 0 0 0 0 0 0 
              0 0 0 0 0 0 0 0 0 0 0 0 0 0 0 0 0 0 0 0 0 0 0 0 0 0 0 0 0 0 0 0 0 0 0 0 0 0 0 0 0 0 0 0 0 0 0 0 
              0 0 0 0 0 0 0 0 0 0 0 0 0 0 0 0 0 0 0 0 0 0 0 0 0 0 0 0 0 0 0 0 0 0 0 0 0 0 0 0 0 0 0 0 0 0 0 0 
              0 0 0 0 0 0 0 0 0 0 0 0 0 0 0 0 0 0 0 0 0 0 0 0 0 0 0 0 0 0 0 0 0 0 0 0 0 0 0 0 0 0 0 0 0 0 0 0 
              0 0 0 0 0 0 0 0 0 0 0 0 0 0 0 0 0 0 0 0 0 0 0 0 0 0 0 0 0 0 0 0 0 0 0 0 0 0 0 0 0 0 0 0 0 0 0 0 
              0 0 0 0 0 0 0 0 0 0 0 0 0 0 0 0 0 0 0 0 0 0 0 0 0 0 0 0 0 0 0 0 0 0 0 0 0 0 0 0 0 0 0 0 0 0 0 0 
              0 0 0 0 0 0 0 0 0 0 0 0 0 0 0 0 0 0 0 0 0 0 0 0 0 0 0 0 0 0 0 0 0 0 0 0 0 0 0 0 0 0 0 0 0 0 0 0 
              0 0 0 0 0 0 0 0 0 0 0 0 0 0 0 0 0 0 0 0 0 0 0 0 0 0 0 0 0 0 0 0 0 0 0 0 0 0 0 0 0 0 0 0 0 0 0 0 
              0 0 0 0 0 0 0 0 0 0 0 0 0 0 0 0 0 0 0 0 0 0 0 0 0 0 0 0 0 0 0 0 0 0 0 0 0 0 0 0 0 0 0 0 0 0 0 0 
              0 0 0 0 0 0 0 0 0 0 0 0 0 0 0 0 0 0 0 0 0 0 0 0 0 0 0 0 0 0 0 0 0 0 0 0 0 0 0 0 0 0 0 0 0 0 0 0 
              0 0 0 0 0 0 0 0 0 0 0 0 0 0 0 0 0 0 0 0 0 0 0 0 0 0 0 0 0 0 0 0 0 0 0 0 0 0 0 0 0 0 0 0 0 0 0 0 
              0 0 0 0 0 0 0 0 0 0 0 0 0 0 0 0 0 0 0 0 0 0 0 0 0 0 0 0 0 0 0 0 0 0 0 0 0 0 0 0 0 0 0 0 0 0 0 0 
              0 0 0 0 0 0 0 0 0 0 0 0 0 0 0 0 0 0 0 0 0 0 0 0 0 0 0 0 0 0 0 0 0 0 0 0 0 0 0 0 0 0 0 0 0 0 0 0 
              0 0 0 0 0 0 0 0 0 0 0 0 0 0 0 0 0 0 0 0 0 0 0 0 0 0 0 0 0 0 0 0 0 0 0 0 0 0 0 0 0 0 0 0 0 0 0 0 
              0 0 0 0 0 0 0 0 0 0 0 0 0 0 0 0 0 0 0 0 0 0 0 0 0 0 0 0 0 0 0 0 0 0 0 0 0 0 0 0 0 0 0 0 0 0 0 0 
              0 0 0 0 0 0 0 0 0 0 0 0 0 0 0 0 0 0 0 0 0 0 0 0 0 0 0 0 0 0 0 0 0 0 0 0 0 0 0 0 0 0 0 0 0 0 0 0 
              0 0 0 0 0 0 0 2 2 2 2 2 2 2 2 2 0 0 0 2 2 2 2 2 2 2 2 2 0 0 0 0 0 0 0 0 0 0 0 0 0 0 0 0 0 0 0 0 
              0 0 0 0 0 0 0 2 2 2 2 2 2 2 2 2 0 0 0 2 2 2 2 2 2 2 2 2 0 0 0 0 0 0 0 0 0 0 0 0 0 0 0 0 0 0 0 0 
              0 0 0 0 0 0 0 2 2 2 2 2 2 2 2 2 0 0 0 2 2 2 2 2 2 2 2 2 0 0 0 0 0 0 0 0 0 0 0 0 0 0 0 0 0 0 0 0 
              0 0 0 0 0 0 0 2 2 2 0 2 0 0 0 2 0 0 0 2 2 2 2 2 2 2 2 2 0 0 0 0 0 0 0 0 0 0 0 0 0 0 0 0 0 0 0 0 
              0 0 0 0 0 0 0 2 2 2 0 0 0 0 0 0 0 0 0 2 2 2 2 2 2 2 2 2 0 0 0 0 0 0 0 0 0 0 0 0 0 0 0 0 0 0 0 0 
              0 0 0 0 0 0 0 2 2 2 0 2 0 0 0 0 0 0 0 2 2 2 2 2 2 2 2 2 0 0 0 0 0 0 0 0 0 0 0 0 0 0 0 0 0 0 0 0 
              0 0 0 0 0 0 0 2 2 2 0 0 0 0 0 0 0 0 0 0 0 0 2 2 2 2 2 2 0 0 0 0 0 0 0 0 0 0 0 0 0 0 0 0 0 0 0 0 
              0 0 0 0 0 0 0 2 2 2 0 0 0 0 0 0 0 0 0 0 0 0 2 2 2 2 2 2 0 0 0 0 0 0 0 0 0 0 0 0 0 0 0 0 0 0 0 0 
              0 0 0 0 0 0 0 2 2 2 0 0 0 0 0 0 0 0 0 0 0 0 2 2 2 2 2 2 0 0 0 0 0 0 0 0 0 0 0 0 0 0 0 0 0 0 0 0 
              0 0 0 0 0 0 0 2 2 2 0 0 0 0 0 0 0 0 0 0 0 0 2 2 2 2 2 2 0 0 0 0 0 0 0 0 0 0 0 0 0 0 0 0 0 0 0 0 
              0 0 0 0 0 0 0 2 2 2 0 0 0 0 0 0 0 0 0 0 0 0 2 2 2 2 2 2 0 0 0 0 0 0 0 0 0 0 0 0 0 0 0 0 0 0 0 0 
              0 0 0 0 0 0 0 2 2 2 0 0 0 0 2 0 0 2 0 0 2 0 2 2 2 2 2 2 0 0 0 0 0 0 0 0 0 0 0 0 0 0 0 0 0 0 0 0 
              0 0 0 0 0 0 0 0 0 0 0 0 0 0 0 0 0 0 0 0 0 0 0 0 0 2 2 2 0 0 0 0 0 0 0 0 0 0 0 0 0 0 0 0 0 0 0 0 
              0 0 0 0 0 0 0 0 0 0 0 0 0 0 0 0 0 0 0 0 0 0 0 2 0 2 2 2 0 0 0 0 0 0 0 0 0 0 0 0 0 0 0 0 0 0 0 0 
              0 0 0 0 0 0 0 0 2 2 0 0 0 0 0 0 0 0 0 0 0 0 0 0 0 2 2 2 0 0 0 0 0 0 0 0 0 0 0 0 0 0 0 0 0 0 0 0 
              0 0 0 0 0 0 0 1 1 1 1 1 1 0 0 0 1 1 1 1 1 1 1 1 1 2 2 2 0 0 0 0 0 0 0 0 0 0 0 0 0 0 0 0 0 0 0 0 
              0 0 0 0 0 0 0 1 1 1 1 1 1 0 0 0 1 1 1 1 1 1 1 1 1 2 2 2 0 0 0 0 0 0 0 0 0 0 0 0 0 0 0 0 0 0 0 0 
              0 0 0 0 0 0 0 1 1 1 1 1 1 0 0 0 1 1 1 1 1 1 1 1 1 2 2 2 0 0 0 0 0 0 0 0 0 0 0 0 0 0 0 0 0 0 0 0 
              0 0 0 0 0 0 0 0 0 0 0 0 0 0 0 0 0 0 0 0 0 0 0 0 0 0 0 0 0 0 0 0 0 0 0 0 0 0 0 0 0 0 0 0 0 0 0 0 
              0 0 0 0 0 0 0 0 0 0 0 0 0 0 0 0 0 0 0 0 0 0 0 0 0 0 0 0 0 0 0 0 0 0 0 0 0 0 0 0 0 0 0 0 0 0 0 0 
			</cellElevations>

			<passableCells>
              0 0 0 0 0 0 0 0 0 0 0 0 0 0 0 0 0 0 0 0 0 0 0 0 0 0 0 0 0 0 0 0 0 0 0 0 0 0 0 0 0 0 0 0 0 0 0 0 
              0 0 0 0 0 0 0 0 0 0 0 0 0 0 0 0 0 0 0 0 0 0 0 0 0 0 0 0 0 0 0 0 0 0 0 0 0 0 0 0 0 0 0 0 0 0 0 0 
              0 0 0 0 0 0 0 0 0 0 0 0 0 0 0 0 0 0 0 0 0 0 0 0 0 0 0 0 0 0 0 0 0 0 0 0 0 0 0 0 0 0 0 0 0 0 0 0 
              0 0 0 0 0 0 0 0 0 0 0 0 0 0 0 0 0 0 0 0 0 0 0 0 0 0 0 0 0 0 0 0 0 0 0 0 0 0 0 0 0 0 0 0 0 0 0 0 
              0 0 0 0 0 0 0 0 0 0 0 0 0 0 0 0 0 0 0 0 0 0 0 0 0 0 0 0 0 0 0 0 0 0 0 0 0 0 0 0 0 0 0 0 0 0 0 0 
              0 0 0 0 0 0 0 0 0 0 0 0 0 0 0 0 0 0 0 0 0 0 0 0 0 0 0 0 0 0 0 0 0 0 0 0 0 0 0 0 0 0 0 0 0 0 0 0 
              0 0 0 0 0 0 0 0 0 0 0 0 0 0 0 0 0 0 0 0 0 0 0 0 0 0 0 0 0 0 0 0 0 0 0 0 0 0 0 0 0 0 0 0 0 0 0 0 
              0 0 0 0 0 0 0 0 0 0 0 0 0 0 0 0 0 0 0 0 0 0 0 0 0 0 0 0 0 0 0 0 0 0 0 0 0 0 0 0 0 0 0 0 0 0 0 0 
              0 0 0 0 0 0 0 0 0 0 0 0 0 0 0 0 0 0 0 0 0 0 0 0 0 0 0 0 0 0 0 0 0 0 0 0 0 0 0 0 0 0 0 0 0 0 0 0 
              0 0 0 0 0 0 0 0 0 0 0 0 0 0 0 0 0 0 0 0 0 0 0 0 0 0 0 0 0 0 0 0 0 0 0 0 0 0 0 0 0 0 0 0 0 0 0 0 
              0 0 0 0 0 0 0 0 0 0 0 0 0 0 0 0 0 0 0 0 0 0 0 0 0 0 0 0 0 0 0 0 0 0 0 0 0 0 0 0 0 0 0 0 0 0 0 0 
              0 0 0 0 0 0 0 0 0 0 0 0 0 0 0 0 0 0 0 0 0 0 0 0 0 0 0 0 0 0 0 0 0 0 0 0 0 0 0 0 0 0 0 0 0 0 0 0 
              0 0 0 0 0 0 0 0 0 0 0 0 0 0 0 0 0 0 0 0 0 0 0 0 0 0 0 0 0 0 0 0 0 0 0 0 0 0 0 0 0 0 0 0 0 0 0 0 
              0 0 0 0 0 0 0 0 0 0 0 0 0 0 0 0 0 0 0 0 0 0 0 0 0 0 0 0 0 0 0 0 0 0 0 0 0 0 0 0 0 0 0 0 0 0 0 0 
              0 0 0 0 0 0 0 0 0 0 0 0 0 0 0 0 0 0 0 0 0 0 0 0 0 0 0 0 0 0 0 0 0 0 0 0 0 0 0 0 0 0 0 0 0 0 0 0 
              0 0 0 0 0 0 0 0 0 0 0 0 0 0 0 0 0 0 0 0 0 0 0 0 0 0 0 0 0 0 0 0 0 0 0 0 0 0 0 0 0 0 0 0 0 0 0 0 
              0 0 0 0 0 0 0 0 0 0 0 0 0 0 0 0 0 0 0 0 0 0 0 0 0 0 0 0 0 0 0 0 0 0 0 0 0 0 0 0 0 0 0 0 0 0 0 0 
              0 0 0 0 0 0 0 0 0 0 0 0 0 0 0 0 1 1 1 0 0 0 0 0 0 0 0 0 0 0 0 0 0 0 0 0 0 0 0 0 0 0 0 0 0 0 0 0 
              0 0 0 0 0 0 0 0 0 0 0 0 0 0 0 0 1 1 1 0 0 0 0 0 0 0 0 0 0 0 0 0 0 0 0 0 0 0 0 0 0 0 0 0 0 0 0 0 
              0 0 0 0 0 0 0 0 0 0 0 0 0 0 0 0 1 1 1 0 0 0 0 0 0 0 0 0 0 0 0 0 0 0 0 0 0 0 0 0 0 0 0 0 0 0 0 0 
              0 0 0 0 0 0 0 0 0 0 0 0 0 0 0 0 1 1 1 0 0 0 0 0 0 0 0 0 0 0 0 0 0 0 0 0 0 0 0 0 0 0 0 0 0 0 0 0 
              0 0 0 0 0 0 0 0 0 0 0 0 0 0 0 0 1 1 1 0 0 0 0 0 0 0 0 0 0 0 0 0 0 0 0 0 0 0 0 0 0 0 0 0 0 0 0 0 
              0 0 0 0 0 0 0 0 0 0 0 0 0 0 0 0 1 1 1 0 0 0 0 0 0 0 0 0 0 0 0 0 0 0 0 0 0 0 0 0 0 0 0 0 0 0 0 0 
              0 0 0 0 0 0 0 0 0 0 1 0 1 1 1 0 1 1 1 1 1 1 1 1 1 0 0 0 0 0 0 0 0 0 0 0 0 0 0 0 0 0 0 0 0 0 0 0 
              0 0 0 0 0 0 0 0 0 0 1 0 1 1 1 1 1 1 1 1 1 1 1 1 1 0 0 0 0 0 0 0 0 0 0 0 0 0 0 0 0 0 0 0 0 0 0 0 
              0 0 0 0 0 0 0 0 0 0 1 0 1 1 1 1 1 1 1 1 1 1 1 1 1 0 0 0 0 0 0 0 0 0 0 0 0 0 0 0 0 0 0 0 0 0 0 0 
              0 0 0 0 0 0 0 0 0 0 0 0 0 0 0 0 0 0 0 0 0 0 1 1 1 0 0 0 0 0 0 0 0 0 0 0 0 0 0 0 0 0 0 0 0 0 0 0 
              0 0 0 0 0 0 0 0 0 0 0 0 0 0 0 0 0 0 0 0 0 0 1 1 1 0 0 0 0 0 0 0 0 0 0 0 0 0 0 0 0 0 0 0 0 0 0 0 
              0 0 0 0 0 0 0 0 0 0 0 0 0 0 0 0 0 0 0 0 0 0 1 1 1 0 0 0 0 0 0 0 0 0 0 0 0 0 0 0 0 0 0 0 0 0 0 0 
              0 0 0 0 0 0 0 0 0 0 1 1 1 1 0 1 1 0 1 1 0 1 1 1 1 0 0 0 0 0 0 0 0 0 0 0 0 0 0 0 0 0 0 0 0 0 0 0 
              0 0 0 0 0 0 0 0 0 0 1 1 1 1 0 1 1 0 1 1 0 1 1 1 1 0 0 0 0 0 0 0 0 0 0 0 0 0 0 0 0 0 0 0 0 0 0 0 
              0 0 0 0 0 0 0 0 0 0 1 1 1 1 1 1 1 1 1 1 1 1 1 1 1 0 0 0 0 0 0 0 0 0 0 0 0 0 0 0 0 0 0 0 0 0 0 0 
              0 0 0 0 0 0 0 0 0 0 1 1 1 1 1 1 1 1 1 1 1 1 1 0 1 0 0 0 0 0 0 0 0 0 0 0 0 0 0 0 0 0 0 0 0 0 0 0 
              0 0 0 0 0 0 0 0 0 0 1 1 1 1 1 1 1 1 1 1 1 1 1 0 1 0 0 0 0 0 0 0 0 0 0 0 0 0 0 0 0 0 0 0 0 0 0 0 
              0 0 0 0 0 0 0 0 0 0 0 0 0 1 1 1 0 0 0 0 0 0 0 0 0 0 0 0 0 0 0 0 0 0 0 0 0 0 0 0 0 0 0 0 0 0 0 0 
              0 0 0 0 0 0 0 0 0 0 0 0 0 1 1 1 0 0 0 0 0 0 0 0 0 0 0 0 0 0 0 0 0 0 0 0 0 0 0 0 0 0 0 0 0 0 0 0 
              0 0 0 0 0 0 0 0 0 0 0 0 0 1 1 1 0 0 0 0 0 0 0 0 0 0 0 0 0 0 0 0 0 0 0 0 0 0 0 0 0 0 0 0 0 0 0 0 
              0 0 0 0 0 0 0 0 0 0 0 0 0 0 0 0 0 0 0 0 0 0 0 0 0 0 0 0 0 0 0 0 0 0 0 0 0 0 0 0 0 0 0 0 0 0 0 0 
              0 0 0 0 0 0 0 0 0 0 0 0 0 1 1 1 0 0 0 0 0 0 0 0 0 0 0 0 0 0 0 0 0 0 0 0 0 0 0 0 0 0 0 0 0 0 0 0 
              0 0 0 0 0 0 0 0 0 0 0 0 0 0 0 0 0 0 0 0 0 0 0 0 0 0 0 0 0 0 0 0 0 0 0 0 0 0 0 0 0 0 0 0 0 0 0 0 
			</passableCells>

			<visibleCells>
              1 1 1 1 1 1 1 1 1 1 1 1 1 1 1 1 1 1 1 1 1 1 1 1 1 1 1 1 1 1 1 1 1 1 1 1 1 1 1 1 1 1 1 1 1 1 1 1 
              1 1 1 1 1 1 1 1 1 1 1 1 1 1 1 1 1 1 1 1 1 1 1 1 1 1 1 1 1 1 1 1 1 1 1 1 1 1 1 1 1 1 1 1 1 1 1 1 
              1 1 1 1 1 1 1 1 1 1 1 1 1 1 1 1 1 1 1 1 1 1 1 1 1 1 1 1 1 1 1 1 1 1 1 1 1 1 1 1 1 1 1 1 1 1 1 1 
              1 1 1 1 1 1 1 1 1 1 1 1 1 1 1 1 1 1 1 1 1 1 1 1 1 1 1 1 1 1 1 1 1 1 1 1 1 1 1 1 1 1 1 1 1 1 1 1 
              1 1 1 1 1 1 1 1 1 1 1 1 1 1 1 1 1 1 1 1 1 1 1 1 1 1 1 1 1 1 1 1 1 1 1 1 1 1 1 1 1 1 1 1 1 1 1 1 
              1 1 1 1 1 1 1 1 1 1 1 1 1 1 1 1 1 1 1 1 1 1 1 1 1 1 1 1 1 1 1 1 1 1 1 1 1 1 1 1 1 1 1 1 1 1 1 1 
              1 1 1 1 1 1 1 1 1 1 1 1 1 1 1 1 1 1 1 1 1 1 1 1 1 1 1 1 1 1 1 1 1 1 1 1 1 1 1 1 1 1 1 1 1 1 1 1 
              1 1 1 1 1 1 1 1 1 1 1 1 1 1 1 1 1 1 1 1 1 1 1 1 1 1 1 1 1 1 1 1 1 1 1 1 1 1 1 1 1 1 1 1 1 1 1 1 
              1 1 1 1 1 1 1 1 1 1 1 1 1 1 1 1 1 1 1 1 1 1 1 1 1 1 1 1 1 1 1 1 1 1 1 1 1 1 1 1 1 1 1 1 1 1 1 1 
              1 1 1 1 1 1 1 1 1 1 1 1 1 1 1 1 1 1 1 1 1 1 1 1 1 1 1 1 1 1 1 1 1 1 1 1 1 1 1 1 1 1 1 1 1 1 1 1 
              1 1 1 1 1 1 1 1 1 1 1 1 1 1 1 1 1 1 1 1 1 1 1 1 1 1 1 1 1 1 1 1 1 1 1 1 1 1 1 1 1 1 1 1 1 1 1 1 
              1 1 1 1 1 1 1 1 1 1 1 1 1 1 1 1 1 1 1 1 1 1 1 1 1 1 1 1 1 1 1 1 1 1 1 1 1 1 1 1 1 1 1 1 1 1 1 1 
              1 1 1 1 1 1 1 1 1 1 1 1 1 1 1 1 1 1 1 1 1 1 1 1 1 1 1 1 1 1 1 1 1 1 1 1 1 1 1 1 1 1 1 1 1 1 1 1 
              1 1 1 1 1 1 1 1 1 1 1 1 1 1 1 1 1 1 1 1 1 1 1 1 1 1 1 1 1 1 1 1 1 1 1 1 1 1 1 1 1 1 1 1 1 1 1 1 
              1 1 1 1 1 1 1 1 1 1 1 1 1 1 1 1 1 1 1 1 1 1 1 1 1 1 1 1 1 1 1 1 1 1 1 1 1 1 1 1 1 1 1 1 1 1 1 1 
              1 1 1 1 1 1 1 1 1 1 1 1 1 1 1 1 1 1 1 1 1 1 1 1 1 1 1 1 1 1 1 1 1 1 1 1 1 1 1 1 1 1 1 1 1 1 1 1 
              1 1 1 1 1 1 1 1 1 1 1 1 1 1 1 1 1 1 1 1 1 1 1 1 1 1 1 1 1 1 1 1 1 1 1 1 1 1 1 1 1 1 1 1 1 1 1 1 
              1 1 1 1 1 1 1 0 0 0 0 0 0 0 0 0 1 1 1 0 0 0 0 0 0 0 0 0 1 1 1 1 1 1 1 1 1 1 1 1 1 1 1 1 1 1 1 1 
              1 1 1 1 1 1 1 0 0 0 0 0 0 0 0 0 1 1 1 0 0 0 0 0 0 0 0 0 1 1 1 1 1 1 1 1 1 1 1 1 1 1 1 1 1 1 1 1 
              1 1 1 1 1 1 1 0 0 0 0 0 0 0 0 0 1 1 1 0 0 0 0 0 0 0 0 0 1 1 1 1 1 1 1 1 1 1 1 1 1 1 1 1 1 1 1 1 
              1 1 1 1 1 1 1 0 0 0 0 0 0 0 0 0 1 1 1 0 0 0 0 0 0 0 0 0 1 1 1 1 1 1 1 1 1 1 1 1 1 1 1 1 1 1 1 1 
              1 1 1 1 1 1 1 0 0 0 0 0 0 0 0 0 1 1 1 0 0 0 0 0 0 0 0 0 1 1 1 1 1 1 1 1 1 1 1 1 1 1 1 1 1 1 1 1 
              1 1 1 1 1 1 1 0 0 0 0 0 0 0 0 0 1 1 1 0 0 0 0 0 0 0 0 0 1 1 1 1 1 1 1 1 1 1 1 1 1 1 1 1 1 1 1 1 
              1 1 1 1 1 1 1 0 0 0 1 1 1 1 1 1 1 1 1 1 1 1 1 1 1 0 0 0 1 1 1 1 1 1 1 1 1 1 1 1 1 1 1 1 1 1 1 1 
              1 1 1 1 1 1 1 0 0 0 1 0 1 1 1 1 1 1 1 1 1 1 1 1 1 0 0 0 1 1 1 1 1 1 1 1 1 1 1 1 1 1 1 1 1 1 1 1 
              1 1 1 1 1 1 1 0 0 0 1 1 1 1 1 1 1 1 1 1 1 1 1 1 1 0 0 0 1 1 1 1 1 1 1 1 1 1 1 1 1 1 1 1 1 1 1 1 
              1 1 1 1 1 1 1 0 0 0 1 1 1 1 1 1 1 1 1 1 1 1 1 1 1 0 0 0 1 1 1 1 1 1 1 1 1 1 1 1 1 1 1 1 1 1 1 1 
              1 1 1 1 1 1 1 0 0 0 1 1 1 1 1 1 1 1 1 1 1 1 1 1 1 0 0 0 1 1 1 1 1 1 1 1 1 1 1 1 1 1 1 1 1 1 1 1 
              1 1 1 1 1 1 1 0 0 0 1 1 1 1 1 1 1 1 1 1 1 1 1 1 1 0 0 0 1 1 1 1 1 1 1 1 1 1 1 1 1 1 1 1 1 1 1 1 
              1 1 1 1 1 1 1 0 0 0 1 1 1 1 0 1 1 0 1 1 0 1 1 1 1 0 0 0 1 1 1 1 1 1 1 1 1 1 1 1 1 1 1 1 1 1 1 1 
              1 1 1 1 1 1 1 0 0 0 1 1 1 1 0 1 1 0 1 1 0 1 1 1 1 0 0 0 1 1 1 1 1 1 1 1 1 1 1 1 1 1 1 1 1 1 1 1 
              1 1 1 1 1 1 1 0 0 0 1 1 1 1 1 1 1 1 1 1 1 1 1 1 1 0 0 0 1 1 1 1 1 1 1 1 1 1 1 1 1 1 1 1 1 1 1 1 
              1 1 1 1 1 1 1 1 0 0 1 1 1 1 1 1 1 1 1 1 1 1 1 0 1 0 0 0 1 1 1 1 1 1 1 1 1 1 1 1 1 1 1 1 1 1 1 1 
              1 1 1 1 1 1 1 1 0 0 1 1 1 1 1 1 1 1 1 1 1 1 1 1 1 0 0 0 1 1 1 1 1 1 1 1 1 1 1 1 1 1 1 1 1 1 1 1 
              1 1 1 1 1 1 1 0 1 1 0 0 0 1 1 1 0 0 0 0 0 0 0 0 0 0 0 0 1 1 1 1 1 1 1 1 1 1 1 1 1 1 1 1 1 1 1 1 
              1 1 1 1 1 1 1 1 1 1 1 1 1 1 1 1 1 1 1 1 1 1 1 1 1 0 0 0 1 1 1 1 1 1 1 1 1 1 1 1 1 1 1 1 1 1 1 1 
              1 1 1 1 1 1 1 1 1 1 1 1 1 1 1 1 1 1 1 1 1 1 1 1 1 0 0 0 1 1 1 1 1 1 1 1 1 1 1 1 1 1 1 1 1 1 1 1 
              1 1 1 1 1 1 1 1 1 1 1 1 1 1 1 1 1 1 1 1 1 1 1 1 1 0 0 0 1 1 1 1 1 1 1 1 1 1 1 1 1 1 1 1 1 1 1 1 
              1 1 1 1 1 1 1 1 1 1 1 1 1 1 1 1 1 1 1 1 1 1 1 1 1 1 1 1 1 1 1 1 1 1 1 1 1 1 1 1 1 1 1 1 1 1 1 1 
              1 1 1 1 1 1 1 1 1 1 1 1 1 1 1 1 1 1 1 1 1 1 1 1 1 1 1 1 1 1 1 1 1 1 1 1 1 1 1 1 1 1 1 1 1 1 1 1 
			</visibleCells>
      </cellData>

      <roomData>
          <room x="9" z="7" width="17" height="11">
          </room>
      </roomData>
  </grid>

  <static>
		<staticObject id="110640" prefab="SD_Column_01" x="15" y="0.0" z="16" width="1" height="1" rotation="180">
      </staticObject>
		<staticObject id="110286" prefab="SD_Hedge_Straight_01" x="7" y="0.0" z="7" width="1" height="1" rotation="90">
      </staticObject>
		<staticObject id="109114" prefab="SD_Hedge_Straight_01" x="13" y="0.0" z="2" width="1" height="1" rotation="180">
      </staticObject>
		<staticObject id="111388" prefab="SD_Hedge_Straight_01" x="7" y="0.0" z="5" width="1" height="1" rotation="90">
      </staticObject>
		<staticObject id="110894" prefab="SD_Hedge_Straight_01" x="15" y="0.0" z="2" width="1" height="1" rotation="180">
      </staticObject>
		<staticObject id="111970" prefab="SD_Hedge_Straight_01" x="7" y="0.0" z="6" width="1" height="1" rotation="90">
      </staticObject>
		<staticObject id="111582" prefab="SD_Hedge_Straight_01" x="14" y="0.0" z="2" width="1" height="1" rotation="180">
      </staticObject>
		<staticObject id="110330" prefab="SD_MedWall_Standalone_01" x="17" y="0.0" z="8" width="1" height="1" rotation="180">
      </staticObject>
		<staticObject id="110584" prefab="SD_MedWall_Standalone_01" x="20" y="0.0" z="8" width="1" height="1" rotation="180">
      </staticObject>
		<staticObject id="111340" prefab="SD_MedWall_Standalone_01" x="14" y="0.0" z="8" width="1" height="1" rotation="180">
      </staticObject>
		<staticObject id="109784" prefab="SD_Nature_TallTree_01" x="23" y="0.0" z="6" width="1" height="1" rotation="180">
      </staticObject>
		<staticObject id="111076" prefab="SD_Nature_TallTree_01" x="11" y="0.0" z="16" width="1" height="1" rotation="180">
      </staticObject>
		<staticObject id="109964" prefab="SD_Nature_TallTree_01" x="11" y="0.0" z="14" width="1" height="1" rotation="180">
      </staticObject>
		<staticObject id="109430" prefab="SD_Nature_TallTree_01" x="9" y="0.0" z="5" width="1" height="1" rotation="180">
      </staticObject>
		<staticObject id="111682" prefab="SD_Nature_TallTree_01" x="8" y="0.0" z="5" width="1" height="1" rotation="180">
      </staticObject>
		<staticObject id="111860" prefab="SD_Short_House_End_01" x="7" y="0.0" z="2" width="3" height="3" rotation="0">
      </staticObject>
		<staticObject id="109356" prefab="SD_Short_House_End_01" x="10" y="0.0" z="2" width="3" height="3" rotation="180">
      </staticObject>
		<staticObject id="109450" prefab="SD_Short_House_End_01" x="16" y="0.0" z="2" width="3" height="3" rotation="0">
      </staticObject>
		<staticObject id="110534" prefab="SD_Short_House_Straight_01" x="22" y="0.0" z="2" width="3" height="3" rotation="180">
      </staticObject>
		<staticObject id="109368" prefab="SD_Short_House_Straight_01" x="19" y="0.0" z="2" width="3" height="3" rotation="180">
      </staticObject>
		<staticObject id="110346" prefab="SD_Tall_House_Corner_01" x="25" y="0.0" z="17" width="3" height="3" rotation="0">
      </staticObject>
		<staticObject id="110374" prefab="SD_Tall_House_Corner_01" x="7" y="0.0" z="17" width="3" height="3" rotation="90">
      </staticObject>
		<staticObject id="110730" prefab="SD_Tall_House_End_01" x="25" y="0.0" z="2" width="3" height="3" rotation="90">
      </staticObject>
		<staticObject id="110072" prefab="SD_Tall_House_End_01" x="7" y="0.0" z="8" width="3" height="3" rotation="90">
      </staticObject>
		<staticObject id="111974" prefab="SD_Tall_House_End_01" x="13" y="0.0" z="17" width="3" height="3" rotation="180">
      </staticObject>
		<staticObject id="111770" prefab="SD_Tall_House_End_01" x="19" y="0.0" z="17" width="3" height="3" rotation="0">
      </staticObject>
		<staticObject id="111178" prefab="SD_Tall_House_Straight_01" x="25" y="0.0" z="8" width="3" height="3" rotation="90">
      </staticObject>
		<staticObject id="110124" prefab="SD_Tall_House_Straight_01" x="25" y="0.0" z="11" width="3" height="3" rotation="90">
      </staticObject>
		<staticObject id="111636" prefab="SD_Tall_House_Straight_01" x="25" y="0.0" z="14" width="3" height="3" rotation="90">
      </staticObject>
		<staticObject id="110224" prefab="SD_Tall_House_Straight_01" x="7" y="0.0" z="11" width="3" height="3" rotation="90">
      </staticObject>
		<staticObject id="109268" prefab="SD_Tall_House_Straight_01" x="22" y="0.0" z="17" width="3" height="3" rotation="180">
      </staticObject>
		<staticObject id="109748" prefab="SD_Tall_House_Straight_01" x="25" y="0.0" z="5" width="3" height="3" rotation="90">
      </staticObject>
		<staticObject id="110648" prefab="SD_Tall_House_Straight_01" x="10" y="0.0" z="17" width="3" height="3" rotation="180">
      </staticObject>
		<staticObject id="110714" prefab="SD_Tall_House_Straight_01" x="7" y="0.0" z="14" width="3" height="3" rotation="90">
      </staticObject>
		<staticObject id="110338" prefab="SD_Tall_Terrace_End_01" x="22" y="0.0" z="8" width="3" height="3" rotation="90">
      </staticObject>
		<staticObject id="110644" prefab="SD_Tall_Terrace_End_01" x="19" y="0.0" z="14" width="3" height="3" rotation="0">
      </staticObject>
		<staticObject id="111962" prefab="SD_Tall_Terrace_Straight_01" x="22" y="0.0" z="14" width="3" height="3" rotation="90">
      </staticObject>
		<staticObject id="111010" prefab="SD_Tall_Terrace_Straight_01" x="22" y="0.0" z="11" width="3" height="3" rotation="90">
      </staticObject>
		<staticObject id="111788" prefab="SD_Chasm_1x3_01" x="19" y="0.0" z="11" width="3" height="1" rotation="0">
      </staticObject>
		<staticObject id="109352" prefab="SD_Chasm_1x3_01" x="19" y="0.0" z="13" width="3" height="1" rotation="180">
      </staticObject>
		<staticObject id="109364" prefab="SD_Chasm_1x3_01" x="10" y="0.0" z="11" width="1" height="3" rotation="270">
      </staticObject>
		<staticObject id="109852" prefab="SD_Chasm_1x3_01" x="21" y="0.0" z="11" width="1" height="3" rotation="90">
      </staticObject>
		<staticObject id="111024" prefab="SD_Chasm_1x9_01" x="10" y="0.0" z="11" width="9" height="1" rotation="0">
      </staticObject>
		<staticObject id="109320" prefab="SD_Chasm_1x9_01" x="10" y="0.0" z="13" width="9" height="1" rotation="180">
      </staticObject>
		<staticObject id="109644" prefab="SD_Floor_Grass_1x2_01" x="10" y="0.0" z="5" width="2" height="1" rotation="180">
      </staticObject>
		<staticObject id="112048" prefab="SD_Floor_Grass_1x2_01" x="8" y="0.0" z="5" width="2" height="1" rotation="180">
      </staticObject>
		<staticObject id="110334" prefab="SD_Floor_Grass_3x3_01" x="13" y="0.0" z="1" width="3" height="3" rotation="180">
      </staticObject>
		<staticObject id="110782" prefab="SD_Floor_Grass_3x3_01" x="9" y="0.0" z="14" width="3" height="3" rotation="180">
      </staticObject>
		<staticObject id="111218" prefab="SD_Floor_Grass_3x3_01" x="23" y="0.0" z="5" width="3" height="3" rotation="180">
      </staticObject>
		<staticObject id="109778" prefab="SD_Floor_GrassStoneCorner_01" x="12" y="0.0" z="6" width="1" height="1" rotation="90">
      </staticObject>
		<staticObject id="111734" prefab="SD_Floor_GrassStoneEdge_1x1_01" x="12" y="0.0" z="5" width="1" height="1" rotation="90">
      </staticObject>
		<staticObject id="110538" prefab="SD_Floor_GrassStoneEdge_1x2_01" x="8" y="0.0" z="6" width="2" height="1" rotation="180">
      </staticObject>
		<staticObject id="109272" prefab="SD_Floor_GrassStoneEdge_1x2_01" x="10" y="0.0" z="6" width="2" height="1" rotation="180">
      </staticObject>
		<staticObject id="110502" prefab="SD_Floor_GrassStoneEdge_1x3_01" x="13" y="0.0" z="4" width="3" height="1" rotation="180">
      </staticObject>
		<staticObject id="110692" prefab="SD_Floor_GrassStoneEdge_1x3_01" x="12" y="0.0" z="14" width="1" height="3" rotation="90">
      </staticObject>
		<staticObject id="109296" prefab="SD_Floor_GrassStoneEdge_1x3_01" x="22" y="0.0" z="5" width="1" height="3" rotation="270">
      </staticObject>
		<staticObject id="110168" prefab="SD_Floor_Stone_1x2_01" x="8" y="0.0" z="7" width="2" height="1" rotation="180">
      </staticObject>
		<staticObject id="110356" prefab="SD_Floor_Stone_1x3_01" x="10" y="0.0" z="10" width="3" height="1" rotation="180">
      </staticObject>
		<staticObject id="109088" prefab="SD_Floor_Stone_3x3_01" x="19" y="0.0" z="5" width="3" height="3" rotation="180">
      </staticObject>
		<staticObject id="110994" prefab="SD_Floor_Stone_3x3_01" x="16" y="0.0" z="14" width="3" height="3" rotation="180">
      </staticObject>
		<staticObject id="111214" prefab="SD_Floor_Stone_3x3_01" x="19" y="0.0" z="8" width="3" height="3" rotation="180">
      </staticObject>
		<staticObject id="111108" prefab="SD_Floor_Stone_3x3_01" x="16" y="0.0" z="5" width="3" height="3" rotation="180">
      </staticObject>
		<staticObject id="111360" prefab="SD_Floor_Stone_3x3_01" x="16" y="0.0" z="8" width="3" height="3" rotation="180">
      </staticObject>
		<staticObject id="109374" prefab="SD_Floor_Stone_3x3_01" x="13" y="0.0" z="8" width="3" height="3" rotation="180">
      </staticObject>
		<staticObject id="110278" prefab="SD_Floor_Stone_3x3_01" x="13" y="0.0" z="5" width="3" height="3" rotation="180">
      </staticObject>
		<staticObject id="110118" prefab="SD_Floor_Stone_3x3_01" x="13" y="0.0" z="14" width="3" height="3" rotation="180">
      </staticObject>
		<staticObject id="110710" prefab="SD_Floor_Stone_3x3_01" x="7" y="0.0" z="8" width="3" height="3" rotation="180">
      </staticObject>
		<staticObject id="111694" prefab="SD_Floor_Stone_3x3_01" x="16" y="0.0" z="20" width="3" height="3" rotation="180">
      </staticObject>
		<staticObject id="111028" prefab="SD_Floor_Stone_3x3_01" x="16" y="0.0" z="17" width="3" height="3" rotation="180">
      </staticObject>
		<staticObject id="111336" prefab="SD_Nature_Water_01" x="7" y="-1.0" z="6" width="18" height="12" rotation="180">
      </staticObject>
	</static>

  <units>
		<playerUnit id="110452" prefab="Assassin" x="19" z="7" rotation="180">
      </playerUnit>
		<playerUnit id="111998" prefab="Thief" x="15" z="7" rotation="180">
      </playerUnit>
  </units>

  <other>
      <dynamicObject id="110078" prefab="GoalZone_AssassinThief" x="17" y="0" z="17" rotation="180">
          <component name="GridZone">
              <property name="SetZoneBounds">
                  <field>-1</field>
                  <field>-1</field>
                  <field>1</field>
                  <field>1</field>
              </property>
          </component>
      </dynamicObject>
      <dynamicObject id="110902" prefab="PressurePlate" x="10" y="0" z="8" rotation="180">
          <component name="BaseSwitch">
          </component>
      </dynamicObject>
      <dynamicObject id="110050" prefab="PressurePlate" x="12" y="0" z="8" rotation="180">
          <component name="BaseSwitch">
          </component>
      </dynamicObject>
      <dynamicObject id="111160" prefab="SD_Interactive_Bridge_3x3_01" x="17" y="0" z="9" rotation="180">
          <component name="Triggerable">
              <property name="SetDecalType">
                  <field>decal_2.png</field>
              </property>
          </component>
      </dynamicObject>
      <dynamicObject id="109578" prefab="SD_Interactive_Elevator_01" x="11" y="0" z="8" rotation="180">
          <component name="Triggerable">
          </component>
          <component name="TriggerElevationChange">
              <property name="SetElevationDiff">
                  <field>1</field>
              </property>
          </component>
      </dynamicObject>
      <dynamicObject id="111752" prefab="SD_KeyPad_01" x="20" y="4" z="15" rotation="180">
          <component name="BaseSwitch">
              <property name="SetDecalType">
                  <field>decal_2.png</field>
              </property>
          </component>
      </dynamicObject>
  </other>

  <links>
      <triggerLink id="111160">
          <switch id="111752">
          </switch>
      </triggerLink>
      <triggerLink id="109578">
          <switch id="110050">
          </switch>
          <switch id="110902">
          </switch>
      </triggerLink>
      <parentLink id="109578">
          <child id="110050">
          </child>
          <child id="110902">
          </child>
      </parentLink>
      <winCondition id="110078">
      </winCondition>
  </links>

	<camera focus="Assassin">
      <start x="18" y="26" z="-12.5">
      </start>
      <overview x="15.97837" y="59.97374" z="-13.16934">
      </overview>
	</camera>

	<lightMap name="SD_Playtest2_05_lightmap.png">
	</lightMap>
</level>
