<level levelName="SD_Playtest2_07">
  <grid>
      <cellData width="64" height="32">
			<cellElevations>
              0 0 0 0 0 0 0 0 0 0 0 0 0 0 0 0 0 0 0 0 0 0 0 0 0 0 0 0 0 0 0 0 0 0 0 0 0 0 0 0 0 0 0 0 0 0 0 0 0 0 0 0 0 0 0 0 0 0 0 0 0 0 0 0 
              0 0 0 0 0 0 0 0 0 0 0 0 0 0 0 0 0 0 0 0 0 0 0 0 0 0 0 0 0 0 0 0 0 0 0 0 0 0 0 0 0 0 0 0 0 0 0 0 0 0 0 0 0 0 0 0 0 0 0 0 0 0 0 0 
              0 0 0 0 0 0 0 0 0 0 0 0 0 0 0 0 0 0 0 0 0 0 0 0 0 0 0 0 0 0 0 0 0 0 0 0 0 0 0 0 0 0 0 0 0 0 0 0 0 0 0 0 0 0 0 0 0 0 0 0 0 0 0 0 
              0 0 0 0 0 0 0 0 0 0 0 0 0 0 0 0 0 0 0 0 0 0 0 0 0 0 0 0 0 0 0 0 0 0 0 0 0 0 0 0 0 0 0 0 0 0 0 0 0 0 0 0 0 0 0 0 0 0 0 0 0 0 0 0 
              0 0 0 0 0 0 0 0 0 0 0 0 0 0 0 0 0 0 0 0 0 0 0 0 0 0 0 0 0 0 0 0 0 0 0 0 0 0 0 0 0 0 0 0 0 0 0 0 0 0 0 0 0 0 0 0 0 0 0 0 0 0 0 0 
              0 0 0 0 0 0 0 0 0 0 0 0 0 0 0 0 0 0 0 0 0 0 0 0 0 0 0 0 0 0 0 0 0 0 0 0 0 0 0 0 0 0 0 0 0 0 0 0 0 0 0 0 0 0 0 0 0 0 0 0 0 0 0 0 
              0 0 0 0 0 0 0 0 0 0 0 0 0 0 0 0 0 0 0 0 0 0 0 0 0 0 0 0 0 0 0 0 0 0 0 0 0 0 0 0 0 0 0 0 0 0 0 0 0 0 0 0 0 0 0 0 0 0 0 0 0 0 0 0 
              0 0 0 0 0 0 0 0 0 0 0 0 0 0 0 0 0 0 0 0 0 0 0 0 0 0 0 0 0 0 0 0 0 0 0 0 0 0 0 0 0 0 0 0 0 0 0 0 0 0 0 0 0 0 0 0 0 0 0 0 0 0 0 0 
              0 0 0 0 0 0 0 0 0 0 0 0 0 0 0 0 0 0 0 0 0 0 0 0 0 0 0 0 0 0 0 0 0 0 0 0 0 0 0 0 0 0 0 0 0 0 0 0 0 0 0 0 0 0 0 0 0 0 0 0 0 0 0 0 
              0 0 0 0 0 0 0 0 0 0 0 0 0 0 0 0 0 0 0 0 0 0 0 0 0 0 0 0 0 0 0 0 0 0 0 0 0 0 0 0 0 0 0 0 0 0 0 0 0 0 0 0 0 0 0 0 0 0 0 0 0 0 0 0 
              0 0 0 0 0 0 0 0 0 0 0 0 0 0 0 0 0 0 0 0 0 0 0 0 0 0 0 0 0 0 0 0 0 0 0 0 0 0 0 0 0 0 0 0 0 0 0 0 0 0 0 0 0 0 0 0 0 0 0 0 0 0 0 0 
              0 0 0 0 0 0 0 0 0 0 0 0 0 0 0 0 0 0 0 0 0 0 0 0 0 0 0 0 0 0 0 0 0 0 0 0 0 0 0 0 0 0 0 0 0 0 0 0 0 0 0 0 0 0 0 0 0 0 0 0 0 0 0 0 
              0 0 0 0 0 0 0 0 0 0 0 0 0 0 0 0 0 0 0 0 0 0 0 0 0 0 0 0 0 0 0 0 0 0 0 0 0 0 0 0 0 0 0 0 0 0 0 0 0 0 0 0 0 0 0 0 0 0 0 0 0 0 0 0 
              0 0 0 0 0 2 2 2 2 2 2 2 2 2 2 2 2 2 2 2 2 2 2 2 2 2 2 2 2 2 2 2 2 2 2 2 2 2 2 2 2 2 0 0 0 0 0 0 0 0 0 0 0 0 0 0 0 0 0 0 0 0 0 0 
              0 0 0 0 0 2 0 0 0 0 0 0 0 0 0 0 0 0 0 0 0 0 0 0 0 0 0 0 0 0 0 0 0 0 0 0 0 0 0 0 0 2 0 0 0 0 0 0 0 0 0 0 0 0 0 0 0 0 0 0 0 0 0 0 
              0 0 0 0 0 2 0 0 0 0 0 0 0 0 0 0 0 0 0 0 0 0 0 0 0 0 0 0 0 0 0 0 0 0 0 0 0 0 0 0 0 2 0 0 0 0 0 0 0 0 0 0 0 0 0 0 0 0 0 0 0 0 0 0 
              0 0 0 0 0 2 0 0 0 0 0 0 0 0 0 0 0 0 0 0 2 2 2 2 2 2 1 1 1 0 2 2 2 0 0 0 0 0 2 2 2 2 0 0 0 0 0 0 0 0 0 0 0 0 0 0 0 0 0 0 0 0 0 0 
              0 0 0 0 0 2 0 0 0 0 0 0 0 0 0 0 0 0 0 0 2 2 2 2 2 2 1 1 1 0 2 2 2 0 0 0 0 0 2 2 2 2 0 0 0 0 0 0 0 0 0 0 0 0 0 0 0 0 0 0 0 0 0 0 
              0 0 0 0 0 2 0 0 0 0 0 0 0 0 0 0 0 0 0 0 2 2 2 2 2 2 1 1 1 0 2 2 2 0 0 0 0 0 2 2 2 2 0 0 0 0 0 0 0 0 0 0 0 0 0 0 0 0 0 0 0 0 0 0 
              0 0 0 0 0 0 0 0 0 0 1 1 1 1 1 1 1 1 1 0 0 0 0 0 0 0 0 0 0 0 0 0 0 0 0 0 0 0 0 0 0 2 0 0 0 0 0 0 0 0 0 0 0 0 0 0 0 0 0 0 0 0 0 0 
              0 0 0 0 0 0 0 0 0 0 1 1 1 1 1 1 1 1 1 0 0 0 0 0 0 0 0 0 0 0 0 0 0 0 0 0 0 0 0 0 0 2 0 0 0 0 0 0 0 0 0 0 0 0 0 0 0 0 0 0 0 0 0 0 
              0 0 0 0 0 0 0 0 0 0 1 1 1 1 1 1 1 1 1 0 0 0 0 0 0 0 0 0 0 0 0 0 0 0 0 0 0 0 0 0 0 2 0 0 0 0 0 0 0 0 0 0 0 0 0 0 0 0 0 0 0 0 0 0 
              0 0 0 0 0 2 0 0 0 0 0 0 0 0 0 0 0 0 0 0 0 0 0 0 0 0 0 0 0 0 0 0 0 0 0 0 0 0 0 0 0 2 0 0 0 0 0 0 0 0 0 0 0 0 0 0 0 0 0 0 0 0 0 0 
              0 0 0 0 0 2 0 0 0 0 0 0 0 0 0 0 0 0 0 0 0 0 0 0 0 0 0 0 0 0 0 0 0 0 0 0 0 0 0 0 0 2 0 0 0 0 0 0 0 0 0 0 0 0 0 0 0 0 0 0 0 0 0 0 
              0 0 0 0 0 2 0 0 0 0 0 0 0 0 0 0 0 0 0 0 0 0 0 0 0 0 0 0 0 0 0 0 0 0 0 0 0 0 0 0 0 2 0 0 0 0 0 0 0 0 0 0 0 0 0 0 0 0 0 0 0 0 0 0 
              0 0 0 0 0 0 0 0 0 0 0 0 0 0 0 0 0 0 0 0 0 0 0 0 0 0 0 0 0 0 0 0 0 0 0 0 0 0 0 0 0 0 0 0 0 0 0 0 0 0 0 0 0 0 0 0 0 0 0 0 0 0 0 0 
              0 0 0 0 0 0 0 0 0 0 0 0 0 0 0 0 0 0 0 0 0 0 0 0 0 0 0 0 0 0 0 0 0 0 0 0 0 0 0 0 0 0 0 0 0 0 0 0 0 0 0 0 0 0 0 0 0 0 0 0 0 0 0 0 
              0 0 0 0 0 0 0 0 0 0 0 0 0 0 0 0 0 0 0 0 0 0 0 0 0 0 0 0 0 0 0 0 0 0 0 0 0 0 0 0 0 0 0 0 0 0 0 0 0 0 0 0 0 0 0 0 0 0 0 0 0 0 0 0 
              0 0 0 0 0 0 0 0 0 0 0 0 0 0 0 0 0 0 0 0 0 0 0 0 0 0 0 0 0 0 0 0 0 0 0 0 0 0 0 0 0 0 0 0 0 0 0 0 0 0 0 0 0 0 0 0 0 0 0 0 0 0 0 0 
              0 0 0 0 0 0 0 0 0 0 0 0 0 0 0 0 0 0 0 0 0 0 0 0 0 0 0 0 0 0 0 0 0 0 0 0 0 0 0 0 0 0 0 0 0 0 0 0 0 0 0 0 0 0 0 0 0 0 0 0 0 0 0 0 
              0 0 0 0 0 0 0 0 0 0 0 0 0 0 0 0 0 0 0 0 0 0 0 0 0 0 0 0 0 0 0 0 0 0 0 0 0 0 0 0 0 0 0 0 0 0 0 0 0 0 0 0 0 0 0 0 0 0 0 0 0 0 0 0 
              0 0 0 0 0 0 0 0 0 0 0 0 0 0 0 0 0 0 0 0 0 0 0 0 0 0 0 0 0 0 0 0 0 0 0 0 0 0 0 0 0 0 0 0 0 0 0 0 0 0 0 0 0 0 0 0 0 0 0 0 0 0 0 0 
			</cellElevations>

			<passableCells>
              0 0 0 0 0 0 0 0 0 0 0 0 0 0 0 0 0 0 0 0 0 0 0 0 0 0 0 0 0 0 0 0 0 0 0 0 0 0 0 0 0 0 0 0 0 0 0 0 0 0 0 0 0 0 0 0 0 0 0 0 0 0 0 0 
              0 0 0 0 0 0 0 0 0 0 0 0 0 0 0 0 0 0 0 0 0 0 0 0 0 0 0 0 0 0 0 0 0 0 0 0 0 0 0 0 0 0 0 0 0 0 0 0 0 0 0 0 0 0 0 0 0 0 0 0 0 0 0 0 
              0 0 0 0 0 0 0 0 0 0 0 0 0 0 0 0 0 0 0 0 0 0 0 0 0 0 0 0 0 0 0 0 0 0 0 0 0 0 0 0 0 0 0 0 0 0 0 0 0 0 0 0 0 0 0 0 0 0 0 0 0 0 0 0 
              0 0 0 0 0 0 0 0 0 0 0 0 0 0 0 0 0 0 0 0 0 0 0 0 0 0 0 0 0 0 0 0 0 0 0 0 0 0 0 0 0 0 0 0 0 0 0 0 0 0 0 0 0 0 0 0 0 0 0 0 0 0 0 0 
              0 0 0 0 0 0 0 0 0 0 0 0 0 0 0 0 0 0 0 0 0 0 0 0 0 0 0 0 0 0 0 0 0 0 0 0 0 0 0 0 0 0 0 0 0 0 0 0 0 0 0 0 0 0 0 0 0 0 0 0 0 0 0 0 
              0 0 0 0 0 0 0 0 0 0 0 0 0 0 0 0 0 0 0 0 0 0 0 0 0 0 0 0 0 0 0 0 0 0 0 0 0 0 0 0 0 0 0 0 0 0 0 0 0 0 0 0 0 0 0 0 0 0 0 0 0 0 0 0 
              0 0 0 0 0 0 0 0 0 0 0 0 0 0 0 0 0 0 0 0 0 0 0 0 0 0 0 0 0 0 0 0 0 0 0 0 0 0 0 0 0 0 0 0 0 0 0 0 0 0 0 0 0 0 0 0 0 0 0 0 0 0 0 0 
              0 0 0 0 0 0 0 0 0 0 0 0 0 0 0 0 0 0 0 0 0 0 0 0 0 0 0 0 0 0 0 0 0 0 0 0 0 0 0 0 0 0 0 0 0 0 0 0 0 0 0 0 0 0 0 0 0 0 0 0 0 0 0 0 
              0 0 0 0 0 0 0 0 0 0 0 0 0 0 0 0 0 0 0 0 0 0 0 0 0 0 0 0 0 0 0 0 0 0 0 0 0 0 0 0 0 0 0 0 0 0 0 0 0 0 0 0 0 0 0 0 0 0 0 0 0 0 0 0 
              0 0 0 0 0 0 0 0 0 0 0 0 0 0 0 0 0 0 0 0 0 0 0 0 0 0 0 0 0 0 0 0 0 0 0 0 0 0 0 0 0 0 0 0 0 0 0 0 0 0 0 0 0 0 0 0 0 0 0 0 0 0 0 0 
              0 0 0 0 0 0 0 0 0 0 0 0 0 0 0 0 0 0 0 0 0 0 0 0 0 0 0 0 0 0 0 0 0 0 0 0 0 0 0 0 0 0 0 0 0 0 0 0 0 0 0 0 0 0 0 0 0 0 0 0 0 0 0 0 
              0 0 0 0 0 0 0 0 0 0 0 0 0 0 0 0 0 0 0 0 0 0 0 0 0 0 0 0 0 0 0 0 0 0 0 0 0 0 0 0 0 0 0 0 0 0 0 0 0 0 0 0 0 0 0 0 0 0 0 0 0 0 0 0 
              0 0 0 0 0 0 0 0 0 0 0 0 0 0 0 0 0 0 0 0 0 0 0 0 0 0 0 0 0 0 0 0 0 0 0 0 0 0 0 0 0 0 0 0 0 0 0 0 0 0 0 0 0 0 0 0 0 0 0 0 0 0 0 0 
              0 0 0 0 0 0 0 0 0 0 0 0 0 0 0 0 0 0 0 0 0 0 0 0 0 0 0 0 0 0 0 0 0 0 0 0 0 0 0 0 0 0 0 0 0 0 0 0 0 0 0 0 0 0 0 0 0 0 0 0 0 0 0 0 
              0 0 0 0 0 0 0 0 0 0 0 0 0 0 0 0 0 0 0 0 0 0 0 0 0 0 0 0 0 0 0 0 0 0 0 0 0 0 0 0 0 0 0 0 0 0 0 0 0 0 0 0 0 0 0 0 0 0 0 0 0 0 0 0 
              0 0 0 0 0 0 0 0 0 0 0 0 0 0 0 0 0 0 0 0 0 0 0 0 0 0 0 0 0 0 0 0 0 0 0 0 0 0 0 0 0 0 0 0 0 0 0 0 0 0 0 0 0 0 0 0 0 0 0 0 0 0 0 0 
              0 0 0 0 0 0 0 0 0 0 0 0 0 0 0 0 0 0 0 0 1 1 1 1 1 1 1 1 1 0 1 1 1 1 1 1 0 0 1 1 1 0 0 0 0 0 0 0 0 0 0 0 0 0 0 0 0 0 0 0 0 0 0 0 
              0 0 0 0 0 0 0 0 0 0 0 0 0 0 0 0 0 0 0 0 1 1 1 1 1 1 1 1 1 0 1 1 1 1 1 1 0 0 1 1 1 0 0 0 0 0 0 0 0 0 0 0 0 0 0 0 0 0 0 0 0 0 0 0 
              0 0 0 0 0 0 0 0 0 0 0 0 0 0 0 0 0 0 0 0 1 1 1 1 1 1 1 1 1 0 1 1 1 1 1 1 0 0 1 1 1 0 0 0 0 0 0 0 0 0 0 0 0 0 0 0 0 0 0 0 0 0 0 0 
              0 0 0 0 1 1 1 1 1 1 1 1 1 1 1 1 1 1 1 0 0 0 0 0 0 0 0 0 0 0 0 0 0 0 0 0 0 0 0 0 0 0 0 0 0 0 0 0 0 0 0 0 0 0 0 0 0 0 0 0 0 0 0 0 
              0 0 0 0 1 0 1 1 1 1 1 1 1 1 1 1 1 1 1 0 0 0 0 0 0 0 0 0 0 0 0 0 0 0 0 0 0 0 0 0 0 0 0 0 0 0 0 0 0 0 0 0 0 0 0 0 0 0 0 0 0 0 0 0 
              0 0 0 0 1 0 1 1 1 1 1 1 1 1 1 1 1 1 1 0 0 0 0 0 0 0 0 0 0 0 0 0 0 0 0 0 0 0 0 0 0 0 0 0 0 0 0 0 0 0 0 0 0 0 0 0 0 0 0 0 0 0 0 0 
              0 0 0 0 0 0 0 0 0 0 0 0 0 0 0 0 1 1 1 1 1 1 1 1 1 1 1 1 1 1 1 1 1 1 1 1 1 1 1 1 1 0 1 0 0 0 0 0 0 0 0 0 0 0 0 0 0 0 0 0 0 0 0 0 
              0 0 0 0 0 0 0 0 0 0 0 0 0 0 0 0 1 1 1 1 1 1 1 1 1 1 1 1 1 1 1 1 1 1 1 1 1 1 1 1 1 0 1 0 0 0 0 0 0 0 0 0 0 0 0 0 0 0 0 0 0 0 0 0 
              0 0 0 0 0 0 0 0 0 0 0 0 0 0 0 0 1 1 1 1 1 1 1 1 1 1 1 1 1 1 1 1 1 1 1 1 1 1 1 1 1 0 1 0 0 0 0 0 0 0 0 0 0 0 0 0 0 0 0 0 0 0 0 0 
              0 0 0 0 0 0 0 0 0 0 0 0 0 0 0 0 0 0 0 0 0 0 0 0 0 0 0 0 0 0 0 0 0 0 0 0 0 0 0 0 0 0 0 0 0 0 0 0 0 0 0 0 0 0 0 0 0 0 0 0 0 0 0 0 
              0 0 0 0 0 0 0 0 0 0 0 0 0 0 0 0 0 0 0 0 0 0 0 0 0 0 0 0 0 0 0 0 0 0 0 0 0 0 0 0 0 0 0 0 0 0 0 0 0 0 0 0 0 0 0 0 0 0 0 0 0 0 0 0 
              0 0 0 0 0 0 0 0 0 0 0 0 0 0 0 0 0 0 0 0 0 0 0 0 0 0 0 0 0 0 0 0 0 0 0 0 0 0 0 0 0 0 0 0 0 0 0 0 0 0 0 0 0 0 0 0 0 0 0 0 0 0 0 0 
              0 0 0 0 0 0 0 0 0 0 0 0 0 0 0 0 0 0 0 0 0 0 0 0 0 0 0 0 0 0 0 0 0 0 0 0 0 0 0 0 0 0 0 0 0 0 0 0 0 0 0 0 0 0 0 0 0 0 0 0 0 0 0 0 
              0 0 0 0 0 0 0 0 0 0 0 0 0 0 0 0 0 0 0 0 0 0 0 0 0 0 0 0 0 0 0 0 0 0 0 0 0 0 0 0 0 0 0 0 0 0 0 0 0 0 0 0 0 0 0 0 0 0 0 0 0 0 0 0 
              0 0 0 0 0 0 0 0 0 0 0 0 0 0 0 0 0 0 0 0 0 0 0 0 0 0 0 0 0 0 0 0 0 0 0 0 0 0 0 0 0 0 0 0 0 0 0 0 0 0 0 0 0 0 0 0 0 0 0 0 0 0 0 0 
              0 0 0 0 0 0 0 0 0 0 0 0 0 0 0 0 0 0 0 0 0 0 0 0 0 0 0 0 0 0 0 0 0 0 0 0 0 0 0 0 0 0 0 0 0 0 0 0 0 0 0 0 0 0 0 0 0 0 0 0 0 0 0 0 
			</passableCells>

			<visibleCells>
              1 1 1 1 1 1 1 1 1 1 1 1 1 1 1 1 1 1 1 1 1 1 1 1 1 1 1 1 1 1 1 1 1 1 1 1 1 1 1 1 1 1 1 1 1 1 1 1 1 1 1 1 1 1 1 1 1 1 1 1 1 1 1 1 
              1 1 1 1 1 1 1 1 1 1 1 1 1 1 1 1 1 1 1 1 1 1 1 1 1 1 1 1 1 1 1 1 1 1 1 1 1 1 1 1 1 1 1 1 1 1 1 1 1 1 1 1 1 1 1 1 1 1 1 1 1 1 1 1 
              1 1 1 1 1 1 1 1 1 1 1 1 1 1 1 1 1 1 1 1 1 1 1 1 1 1 1 1 1 1 1 1 1 1 1 1 1 1 1 1 1 1 1 1 1 1 1 1 1 1 1 1 1 1 1 1 1 1 1 1 1 1 1 1 
              1 1 1 1 1 1 1 1 1 1 1 1 1 1 1 1 1 1 1 1 1 1 1 1 1 1 1 1 1 1 1 1 1 1 1 1 1 1 1 1 1 1 1 1 1 1 1 1 1 1 1 1 1 1 1 1 1 1 1 1 1 1 1 1 
              1 1 1 1 1 1 1 1 1 1 1 1 1 1 1 1 1 1 1 1 1 1 1 1 1 1 1 1 1 1 1 1 1 1 1 1 1 1 1 1 1 1 1 1 1 1 1 1 1 1 1 1 1 1 1 1 1 1 1 1 1 1 1 1 
              1 1 1 1 1 1 1 1 1 1 1 1 1 1 1 1 1 1 1 1 1 1 1 1 1 1 1 1 1 1 1 1 1 1 1 1 1 1 1 1 1 1 1 1 1 1 1 1 1 1 1 1 1 1 1 1 1 1 1 1 1 1 1 1 
              1 1 1 1 1 1 1 1 1 1 1 1 1 1 1 1 1 1 1 1 1 1 1 1 1 1 1 1 1 1 1 1 1 1 1 1 1 1 1 1 1 1 1 1 1 1 1 1 1 1 1 1 1 1 1 1 1 1 1 1 1 1 1 1 
              1 1 1 1 1 1 1 1 1 1 1 1 1 1 1 1 1 1 1 1 1 1 1 1 1 1 1 1 1 1 1 1 1 1 1 1 1 1 1 1 1 1 1 1 1 1 1 1 1 1 1 1 1 1 1 1 1 1 1 1 1 1 1 1 
              1 1 1 1 1 1 1 1 1 1 1 1 1 1 1 1 1 1 1 1 1 1 1 1 1 1 1 1 1 1 1 1 1 1 1 1 1 1 1 1 1 1 1 1 1 1 1 1 1 1 1 1 1 1 1 1 1 1 1 1 1 1 1 1 
              1 1 1 1 1 1 1 1 1 1 1 1 1 1 1 1 1 1 1 1 1 1 1 1 1 1 1 1 1 1 1 1 1 1 1 1 1 1 1 1 1 1 1 1 1 1 1 1 1 1 1 1 1 1 1 1 1 1 1 1 1 1 1 1 
              1 1 1 1 1 1 1 1 1 1 1 1 1 1 1 1 1 1 1 1 1 1 1 1 1 1 1 1 1 1 1 1 1 1 1 1 1 1 1 1 1 1 1 1 1 1 1 1 1 1 1 1 1 1 1 1 1 1 1 1 1 1 1 1 
              1 1 1 1 1 0 0 0 0 0 0 0 0 0 0 0 0 0 0 0 0 0 0 0 0 0 0 0 0 0 0 0 0 0 0 0 0 0 0 0 0 0 1 1 1 1 1 1 1 1 1 1 1 1 1 1 1 1 1 1 1 1 1 1 
              1 1 1 1 1 0 0 0 0 0 0 0 0 0 0 0 0 0 0 0 0 0 0 0 0 0 0 0 0 0 0 0 0 0 0 0 0 0 0 0 0 0 1 1 1 1 1 1 1 1 1 1 1 1 1 1 1 1 1 1 1 1 1 1 
              1 1 1 1 1 1 1 1 1 1 1 1 1 1 1 1 1 1 1 1 1 1 1 1 1 1 1 1 1 1 1 1 1 1 1 1 1 1 1 1 1 1 1 1 1 1 1 1 1 1 1 1 1 1 1 1 1 1 1 1 1 1 1 1 
              1 1 1 1 1 1 1 1 1 1 1 1 1 1 1 1 1 1 1 1 0 0 0 0 0 0 1 1 1 1 0 0 0 1 1 1 1 1 0 0 0 1 1 1 1 1 1 1 1 1 1 1 1 1 1 1 1 1 1 1 1 1 1 1 
              1 1 1 1 1 1 1 1 1 1 1 1 1 1 1 1 1 1 1 1 0 0 0 0 0 0 0 0 0 1 0 0 0 1 1 1 1 1 0 0 0 1 1 1 1 1 1 1 1 1 1 1 1 1 1 1 1 1 1 1 1 1 1 1 
              1 1 1 1 1 1 1 1 1 1 1 1 1 1 1 1 1 1 1 1 1 1 1 1 1 1 1 1 1 1 1 1 1 1 1 1 1 1 1 1 1 1 1 1 1 1 1 1 1 1 1 1 1 1 1 1 1 1 1 1 1 1 1 1 
              1 1 1 1 1 1 1 1 1 1 1 1 1 1 1 1 1 1 1 1 1 1 1 1 1 1 1 1 1 1 1 1 1 1 1 1 1 1 1 1 1 1 1 1 1 1 1 1 1 1 1 1 1 1 1 1 1 1 1 1 1 1 1 1 
              1 1 1 1 1 1 1 1 1 1 0 0 0 0 0 0 0 0 0 1 1 1 1 1 1 1 1 1 1 1 1 1 1 1 1 1 1 1 1 1 1 1 1 1 1 1 1 1 1 1 1 1 1 1 1 1 1 1 1 1 1 1 1 1 
              1 1 1 1 1 1 1 1 1 1 1 1 1 1 1 1 1 1 1 1 1 1 1 1 1 1 1 1 1 1 1 1 1 1 1 1 1 1 1 1 1 1 1 1 1 1 1 1 1 1 1 1 1 1 1 1 1 1 1 1 1 1 1 1 
              1 1 1 1 1 0 1 1 1 1 1 1 1 1 1 1 1 1 1 1 1 1 1 1 1 1 1 1 1 1 1 1 1 1 1 1 1 1 1 1 1 1 1 1 1 1 1 1 1 1 1 1 1 1 1 1 1 1 1 1 1 1 1 1 
              1 1 1 1 1 0 1 1 1 1 1 1 1 1 1 1 1 1 1 1 1 1 1 1 1 1 1 1 1 1 1 1 1 1 1 1 1 1 1 1 1 1 1 1 1 1 1 1 1 1 1 1 1 1 1 1 1 1 1 1 1 1 1 1 
              1 1 1 1 1 1 1 1 1 1 1 1 1 1 1 1 1 1 1 1 1 1 1 1 1 1 1 1 1 1 1 1 1 1 1 1 1 1 1 1 1 1 1 1 1 1 1 1 1 1 1 1 1 1 1 1 1 1 1 1 1 1 1 1 
              1 1 1 1 1 1 1 1 1 1 1 1 1 1 1 1 1 1 1 1 1 1 1 1 1 1 1 1 1 1 1 1 1 1 1 1 1 1 1 1 1 1 1 1 1 1 1 1 1 1 1 1 1 1 1 1 1 1 1 1 1 1 1 1 
              1 1 1 1 1 1 1 1 1 1 1 1 1 1 1 1 1 1 1 1 1 1 1 1 1 1 1 1 1 1 1 1 1 1 1 1 1 1 1 1 1 1 1 1 1 1 1 1 1 1 1 1 1 1 1 1 1 1 1 1 1 1 1 1 
              1 1 1 1 1 1 1 1 1 1 1 1 1 1 1 1 1 1 1 1 1 1 1 1 1 1 1 1 1 1 1 1 1 1 1 1 1 1 1 1 1 1 1 1 1 1 1 1 1 1 1 1 1 1 1 1 1 1 1 1 1 1 1 1 
              1 1 1 1 1 1 1 1 1 1 1 1 1 1 1 1 1 1 1 1 1 1 1 1 1 1 1 1 1 1 1 1 1 1 1 1 1 1 1 1 1 1 1 1 1 1 1 1 1 1 1 1 1 1 1 1 1 1 1 1 1 1 1 1 
              1 1 1 1 1 1 1 1 1 1 1 1 1 1 1 1 1 1 1 1 1 1 1 1 1 1 1 1 1 1 1 1 1 1 1 1 1 1 1 1 1 1 1 1 1 1 1 1 1 1 1 1 1 1 1 1 1 1 1 1 1 1 1 1 
              1 1 1 1 1 1 1 1 1 1 1 1 1 1 1 1 1 1 1 1 1 1 1 1 1 1 1 1 1 1 1 1 1 1 1 1 1 1 1 1 1 1 1 1 1 1 1 1 1 1 1 1 1 1 1 1 1 1 1 1 1 1 1 1 
              1 1 1 1 1 1 1 1 1 1 1 1 1 1 1 1 1 1 1 1 1 1 1 1 1 1 1 1 1 1 1 1 1 1 1 1 1 1 1 1 1 1 1 1 1 1 1 1 1 1 1 1 1 1 1 1 1 1 1 1 1 1 1 1 
              1 1 1 1 1 1 1 1 1 1 1 1 1 1 1 1 1 1 1 1 1 1 1 1 1 1 1 1 1 1 1 1 1 1 1 1 1 1 1 1 1 1 1 1 1 1 1 1 1 1 1 1 1 1 1 1 1 1 1 1 1 1 1 1 
              1 1 1 1 1 1 1 1 1 1 1 1 1 1 1 1 1 1 1 1 1 1 1 1 1 1 1 1 1 1 1 1 1 1 1 1 1 1 1 1 1 1 1 1 1 1 1 1 1 1 1 1 1 1 1 1 1 1 1 1 1 1 1 1 
			</visibleCells>
      </cellData>

      <roomData>
          <room x="6" z="7" width="17" height="11">
          </room>
          <room x="24" z="7" width="17" height="11">
          </room>
      </roomData>
  </grid>

  <static>
		<staticObject id="-12106932" prefab="SD_HighWall_Corner_01" x="41" y="0.0" z="18" width="1" height="1" rotation="180">
      </staticObject>
		<staticObject id="-12139204" prefab="SD_HighWall_Corner_01" x="5" y="0.0" z="18" width="1" height="1" rotation="180">
      </staticObject>
		<staticObject id="-12074922" prefab="SD_HighWall_End_01" x="41" y="0.0" z="7" width="1" height="1" rotation="180">
      </staticObject>
		<staticObject id="-12143024" prefab="SD_HighWall_End_01" x="5" y="0.0" z="7" width="1" height="1" rotation="180">
      </staticObject>
		<staticObject id="-12224702" prefab="SD_HighWall_End_01" x="5" y="0.0" z="9" width="1" height="1" rotation="180">
      </staticObject>
		<staticObject id="-12225560" prefab="SD_HighWall_End_01" x="5" y="0.0" z="13" width="1" height="1" rotation="180">
      </staticObject>
		<staticObject id="-12099166" prefab="SD_HighWall_Straight_1x1_01" x="41" y="0.0" z="17" width="1" height="1" rotation="90">
      </staticObject>
		<staticObject id="-12142982" prefab="SD_HighWall_Straight_1x1_01" x="5" y="0.0" z="17" width="1" height="1" rotation="90">
      </staticObject>
		<staticObject id="-12228254" prefab="SD_HighWall_Straight_1x1_01" x="5" y="0.0" z="8" width="1" height="1" rotation="90">
      </staticObject>
		<staticObject id="-12134420" prefab="SD_HighWall_Straight_1x3_01" x="6" y="0.0" z="18" width="3" height="1" rotation="180">
      </staticObject>
		<staticObject id="-12232632" prefab="SD_HighWall_Straight_1x3_01" x="5" y="0.0" z="14" width="1" height="3" rotation="90">
      </staticObject>
		<staticObject id="-12125978" prefab="SD_HighWall_Straight_1x5_01" x="9" y="0.0" z="18" width="5" height="1" rotation="180">
      </staticObject>
		<staticObject id="-12085380" prefab="SD_HighWall_Straight_1x9_01" x="41" y="0.0" z="8" width="1" height="9" rotation="90">
      </staticObject>
		<staticObject id="-12117068" prefab="SD_HighWall_Straight_1x9_01" x="32" y="0.0" z="18" width="9" height="1" rotation="180">
      </staticObject>
		<staticObject id="-12119874" prefab="SD_HighWall_Straight_1x9_01" x="23" y="0.0" z="18" width="9" height="1" rotation="180">
      </staticObject>
		<staticObject id="-12121388" prefab="SD_HighWall_Straight_1x9_01" x="14" y="0.0" z="18" width="9" height="1" rotation="180">
      </staticObject>
		<staticObject id="317626" prefab="SD_Short_Terrace_Corner_01" x="16" y="-2.0" z="7" width="3" height="3" rotation="180">
      </staticObject>
		<staticObject id="317710" prefab="SD_Short_Terrace_End_01" x="26" y="0.0" z="13" width="3" height="3" rotation="180">
      </staticObject>
		<staticObject id="316466" prefab="SD_Short_Terrace_End_01" x="7" y="-2.0" z="10" width="3" height="3" rotation="180">
      </staticObject>
		<staticObject id="317124" prefab="SD_Short_Terrace_Straight_01" x="13" y="0.0" z="10" width="3" height="3" rotation="180">
      </staticObject>
		<staticObject id="316688" prefab="SD_Short_Terrace_Straight_01" x="4" y="-2.0" z="10" width="3" height="3" rotation="180">
      </staticObject>
		<staticObject id="317362" prefab="SD_Short_Terrace_Straight_01" x="37" y="-2.0" z="7" width="3" height="3" rotation="180">
      </staticObject>
		<staticObject id="317758" prefab="SD_Short_Terrace_Straight_01" x="22" y="-2.0" z="7" width="3" height="3" rotation="180">
      </staticObject>
		<staticObject id="317696" prefab="SD_Short_Terrace_Straight_01" x="40" y="-2.0" z="7" width="3" height="3" rotation="180">
      </staticObject>
		<staticObject id="317068" prefab="SD_Short_Terrace_Straight_01" x="19" y="-2.0" z="7" width="3" height="3" rotation="180">
      </staticObject>
		<staticObject id="317198" prefab="SD_Short_Terrace_Straight_01" x="28" y="-2.0" z="7" width="3" height="3" rotation="180">
      </staticObject>
		<staticObject id="317580" prefab="SD_Short_Terrace_Straight_01" x="34" y="-2.0" z="7" width="3" height="3" rotation="180">
      </staticObject>
		<staticObject id="317742" prefab="SD_Short_Terrace_Straight_01" x="31" y="-2.0" z="7" width="3" height="3" rotation="180">
      </staticObject>
		<staticObject id="317544" prefab="SD_Short_Terrace_Straight_01" x="25" y="-2.0" z="7" width="3" height="3" rotation="180">
      </staticObject>
		<staticObject id="316780" prefab="SD_Tall_Terrace_End_01" x="38" y="0.0" z="13" width="3" height="3" rotation="0">
      </staticObject>
		<staticObject id="316902" prefab="SD_Tall_Terrace_End_01" x="23" y="0.0" z="13" width="3" height="3" rotation="180">
      </staticObject>
		<staticObject id="316802" prefab="SD_Tall_Terrace_End_01" x="20" y="0.0" z="13" width="3" height="3" rotation="0">
      </staticObject>
		<staticObject id="-12161560" prefab="SD_Chasm_1x3_01" x="38" y="0.0" z="12" width="3" height="1" rotation="180">
      </staticObject>
		<staticObject id="-12164616" prefab="SD_Chasm_1x3_01" x="40" y="0.0" z="10" width="1" height="3" rotation="90">
      </staticObject>
		<staticObject id="-12169140" prefab="SD_Chasm_1x3_01" x="37" y="0.0" z="13" width="1" height="3" rotation="90">
      </staticObject>
		<staticObject id="-12182166" prefab="SD_Chasm_1x3_01" x="29" y="0.0" z="13" width="1" height="3" rotation="270">
      </staticObject>
		<staticObject id="-12186150" prefab="SD_Chasm_1x3_01" x="19" y="0.0" z="13" width="1" height="3" rotation="90">
      </staticObject>
		<staticObject id="-12189402" prefab="SD_Chasm_1x3_01" x="13" y="0.0" z="9" width="3" height="1" rotation="180">
      </staticObject>
		<staticObject id="-12207084" prefab="SD_Chasm_1x3_01" x="7" y="-2.0" z="9" width="3" height="1" rotation="180">
      </staticObject>
		<staticObject id="-12209060" prefab="SD_Chasm_1x3_01" x="4" y="-2.0" z="9" width="3" height="1" rotation="180">
      </staticObject>
		<staticObject id="-12220244" prefab="SD_Chasm_1x3_01" x="15" y="0.0" z="7" width="1" height="3" rotation="90">
      </staticObject>
		<staticObject id="-12146894" prefab="SD_Chasm_1x9_01" x="5" y="0.0" z="17" width="9" height="1" rotation="180">
      </staticObject>
		<staticObject id="-12150080" prefab="SD_Chasm_1x9_01" x="14" y="0.0" z="17" width="9" height="1" rotation="180">
      </staticObject>
		<staticObject id="-12151772" prefab="SD_Chasm_1x9_01" x="23" y="0.0" z="17" width="9" height="1" rotation="180">
      </staticObject>
		<staticObject id="-12153906" prefab="SD_Chasm_1x9_01" x="32" y="0.0" z="17" width="9" height="1" rotation="180">
      </staticObject>
		<staticObject id="-12178748" prefab="SD_Chasm_1x9_01" x="20" y="0.0" z="12" width="9" height="1" rotation="180">
      </staticObject>
		<staticObject id="-12211128" prefab="SD_Chasm_1x9_01" x="16" y="-2.0" z="6" width="9" height="1" rotation="180">
      </staticObject>
		<staticObject id="-12214254" prefab="SD_Chasm_1x9_01" x="25" y="-2.0" z="6" width="9" height="1" rotation="180">
      </staticObject>
		<staticObject id="-12215840" prefab="SD_Chasm_1x9_01" x="34" y="-2.0" z="6" width="9" height="1" rotation="180">
      </staticObject>
		<staticObject id="-12196370" prefab="SD_Nature_Water_01" x="0" y="-3.0" z="0" width="1" height="1" rotation="180">
      </staticObject>
		<staticObject id="-12201546" prefab="SD_Nature_Water_01" x="0" y="-3.0" z="0" width="1" height="1" rotation="180">
      </staticObject>
	</static>

  <units>
		<playerUnit id="317072" prefab="Assassin" x="39" z="8" rotation="180">
      </playerUnit>
		<playerUnit id="316758" prefab="Thief" x="39" z="14" rotation="180">
      </playerUnit>
  </units>

  <other>
      <dynamicObject id="316300" prefab="ScreenTransZone" x="23" y="0" z="8" rotation="90">
          <component name="TransitionZone">
              <property name="SetZoneBounds">
                  <field>-1</field>
                  <field>-1</field>
                  <field>1</field>
                  <field>1</field>
              </property>
              <property name="SetFirstDestination">
                  <field>0</field>
                  <field>-2</field>
              </property>
              <property name="SetSecondDestination">
                  <field>0</field>
                  <field>2</field>
              </property>
          </component>
      </dynamicObject>
      <dynamicObject id="316812" prefab="ScreenTransZone" x="23" y="4" z="14" rotation="90">
          <component name="TransitionZone">
              <property name="SetZoneBounds">
                  <field>-1</field>
                  <field>-1</field>
                  <field>1</field>
                  <field>1</field>
              </property>
              <property name="SetFirstDestination">
                  <field>0</field>
                  <field>-2</field>
              </property>
              <property name="SetSecondDestination">
                  <field>0</field>
                  <field>2</field>
              </property>
          </component>
      </dynamicObject>
      <dynamicObject id="317618" prefab="GoalZone_AssassinThief" x="6" y="0" z="11" rotation="180">
          <component name="GridZone">
              <property name="SetZoneBounds">
                  <field>-1</field>
                  <field>-1</field>
                  <field>1</field>
                  <field>1</field>
              </property>
          </component>
      </dynamicObject>
      <dynamicObject id="316658" prefab="PressurePlate" x="28" y="0" z="8" rotation="180">
          <component name="BaseSwitch">
              <property name="SetDecalType">
                  <field>decal_2.png</field>
              </property>
          </component>
      </dynamicObject>
      <dynamicObject id="316498" prefab="PressurePlate" x="11" y="2" z="11" rotation="180">
          <component name="BaseSwitch">
          </component>
      </dynamicObject>
      <dynamicObject id="316920" prefab="PressurePlate" x="30" y="0" z="8" rotation="180">
          <component name="BaseSwitch">
              <property name="SetDecalType">
                  <field>decal_3.png</field>
              </property>
          </component>
      </dynamicObject>
      <dynamicObject id="316866" prefab="PressurePlate" x="17" y="2" z="11" rotation="180">
          <component name="BaseSwitch">
          </component>
      </dynamicObject>
      <dynamicObject id="317656" prefab="SD_Interactive_Elevator_01" x="34" y="0" z="14" rotation="180">
          <component name="Triggerable">
              <property name="SetDecalType">
                  <field>decal_3.png</field>
              </property>
          </component>
          <component name="TriggerElevationChange">
              <property name="SetElevationDiff">
                  <field>1</field>
              </property>
          </component>
      </dynamicObject>
      <dynamicObject id="317606" prefab="SD_Interactive_Elevator_01" x="17" y="2" z="11" rotation="180">
          <component name="Triggerable">
              <property name="SetToggleState">
                  <field>true</field>
              </property>
          </component>
          <component name="TriggerElevationChange">
              <property name="SetElevationDiff">
                  <field>1</field>
              </property>
          </component>
      </dynamicObject>
      <dynamicObject id="316530" prefab="SD_Interactive_Elevator_01" x="11" y="2" z="11" rotation="180">
          <component name="Triggerable">
              <property name="SetToggleState">
                  <field>true</field>
              </property>
          </component>
          <component name="TriggerElevationChange">
              <property name="SetElevationDiff">
                  <field>1</field>
              </property>
          </component>
      </dynamicObject>
      <dynamicObject id="316972" prefab="SD_Interactive_Elevator_01" x="31" y="4" z="14" rotation="180">
          <component name="Triggerable">
              <property name="SetToggleState">
                  <field>true</field>
              </property>
          </component>
          <component name="Triggerable">
              <property name="SetDecalType">
                  <field>decal_2.png</field>
              </property>
          </component>
          <component name="TriggerElevationChange">
              <property name="SetElevationDiff">
                  <field>1</field>
              </property>
          </component>
      </dynamicObject>
  </other>

  <links>
      <triggerLink id="317656">
          <switch id="316920">
          </switch>
      </triggerLink>
      <triggerLink id="317606">
          <switch id="316866">
          </switch>
      </triggerLink>
      <triggerLink id="316530">
          <switch id="316498">
          </switch>
      </triggerLink>
      <triggerLink id="316972">
          <switch id="316658">
          </switch>
      </triggerLink>
      <parentLink id="316530">
          <child id="316498">
          </child>
      </parentLink>
      <parentLink id="317606">
          <child id="316866">
          </child>
      </parentLink>
      <winCondition id="317618">
      </winCondition>
  </links>

	<camera focus="Assassin">
      <start x="32" y="26" z="-12.5">
      </start>
      <overview x="31.97837" y="84.97374" z="-11.16934">
      </overview>
	</camera>

	<lightMap name="SD_Playtest2_07_lightmap.png">
	</lightMap>
</level>
