<level levelName="SD_Playtest2_05">
  <grid>
      <cellData width="48" height="40">
			<cellElevations>
              0 0 0 0 0 0 0 0 0 0 0 0 0 0 0 0 0 0 0 0 0 0 0 0 0 0 0 0 0 0 0 0 0 0 0 0 0 0 0 0 0 0 0 0 0 0 0 0 
              0 0 0 0 0 0 0 0 0 0 0 0 0 0 0 0 0 0 0 0 0 0 0 0 0 0 0 0 0 0 0 0 0 0 0 0 0 0 0 0 0 0 0 0 0 0 0 0 
              0 0 0 0 0 0 0 0 0 0 0 0 0 0 0 0 0 0 0 0 0 0 0 0 0 0 0 0 0 0 0 0 0 0 0 0 0 0 0 0 0 0 0 0 0 0 0 0 
              0 0 0 0 0 0 0 0 0 0 0 0 0 0 0 0 0 0 0 0 0 0 0 0 0 0 0 0 0 0 0 0 0 0 0 0 0 0 0 0 0 0 0 0 0 0 0 0 
              0 0 0 0 0 0 0 0 0 0 0 0 0 0 0 0 0 0 0 0 0 0 0 0 0 0 0 0 0 0 0 0 0 0 0 0 0 0 0 0 0 0 0 0 0 0 0 0 
              0 0 0 0 0 0 0 0 0 0 0 0 0 0 0 0 0 0 0 0 0 0 0 0 0 0 0 0 0 0 0 0 0 0 0 0 0 0 0 0 0 0 0 0 0 0 0 0 
              0 0 0 0 0 0 0 0 0 0 0 0 0 0 0 0 0 0 0 0 0 0 0 0 0 0 0 0 0 0 0 0 0 0 0 0 0 0 0 0 0 0 0 0 0 0 0 0 
              0 0 0 0 0 0 0 0 0 0 0 0 0 0 0 0 0 0 0 0 0 0 0 0 0 0 0 0 0 0 0 0 0 0 0 0 0 0 0 0 0 0 0 0 0 0 0 0 
              0 0 0 0 0 0 0 0 0 0 0 0 0 0 0 0 0 0 0 0 0 0 0 0 0 0 0 0 0 0 0 0 0 0 0 0 0 0 0 0 0 0 0 0 0 0 0 0 
              0 0 0 0 0 0 0 0 0 0 0 0 0 0 0 0 0 0 0 0 0 0 0 0 0 0 0 0 0 0 0 0 0 0 0 0 0 0 0 0 0 0 0 0 0 0 0 0 
              0 0 0 0 0 0 0 0 0 0 0 0 0 0 0 0 0 0 0 0 0 0 0 0 0 0 0 0 0 0 0 0 0 0 0 0 0 0 0 0 0 0 0 0 0 0 0 0 
              0 0 0 0 0 0 0 0 0 0 0 0 0 0 0 0 0 0 0 0 0 0 0 0 0 0 0 0 0 0 0 0 0 0 0 0 0 0 0 0 0 0 0 0 0 0 0 0 
              0 0 0 0 0 0 0 0 0 0 0 0 0 0 0 0 0 0 0 0 0 0 0 0 0 0 0 0 0 0 0 0 0 0 0 0 0 0 0 0 0 0 0 0 0 0 0 0 
              0 0 0 0 0 0 0 0 0 0 0 0 0 0 0 0 0 0 0 0 0 0 0 0 0 0 0 0 0 0 0 0 0 0 0 0 0 0 0 0 0 0 0 0 0 0 0 0 
              0 0 0 0 0 0 0 0 0 0 0 0 0 0 0 0 0 0 0 0 0 0 0 0 0 0 0 0 0 0 0 0 0 0 0 0 0 0 0 0 0 0 0 0 0 0 0 0 
              0 0 0 0 0 0 0 0 0 0 0 0 0 0 0 0 0 0 0 0 0 0 0 0 0 0 0 0 0 0 0 0 0 0 0 0 0 0 0 0 0 0 0 0 0 0 0 0 
              0 0 0 0 0 0 0 0 0 0 0 0 0 0 0 0 0 0 0 0 0 0 0 0 0 0 0 0 0 0 0 0 0 0 0 0 0 0 0 0 0 0 0 0 0 0 0 0 
              0 0 0 0 0 0 0 0 0 0 0 0 0 0 0 0 0 0 0 0 0 0 0 0 0 0 0 0 0 0 0 0 0 0 0 0 0 0 0 0 0 0 0 0 0 0 0 0 
              0 0 0 0 0 0 0 0 0 0 0 0 0 0 0 0 0 0 0 0 0 0 0 0 0 0 0 0 0 0 0 0 0 0 0 0 0 0 0 0 0 0 0 0 0 0 0 0 
              0 0 0 0 0 0 0 0 0 0 0 0 0 0 0 0 0 0 0 0 0 0 0 0 0 0 0 0 0 0 0 0 0 0 0 0 0 0 0 0 0 0 0 0 0 0 0 0 
              0 0 0 0 2 2 2 2 2 2 2 2 2 2 2 2 0 0 0 2 2 2 2 2 2 2 2 2 0 0 0 0 0 0 0 0 0 0 0 0 0 0 0 0 0 0 0 0 
              0 0 0 0 2 2 2 2 2 2 2 2 2 2 2 2 0 0 0 2 2 2 2 2 2 2 2 2 0 0 0 0 0 0 0 0 0 0 0 0 0 0 0 0 0 0 0 0 
              0 0 0 0 2 2 2 2 2 2 2 2 2 2 2 2 0 0 0 2 2 2 2 2 2 2 2 2 0 0 0 0 0 0 0 0 0 0 0 0 0 0 0 0 0 0 0 0 
              0 0 0 0 2 2 2 0 0 0 0 0 0 0 0 2 0 0 0 2 2 2 2 2 2 2 2 2 0 0 0 0 0 0 0 0 0 0 0 0 0 0 0 0 0 0 0 0 
              0 0 0 0 2 2 2 2 2 2 0 0 0 0 0 0 0 0 0 2 2 2 2 2 2 2 2 2 0 0 0 0 0 0 0 0 0 0 0 0 0 0 0 0 0 0 0 0 
              0 0 0 0 2 2 2 2 2 2 0 0 0 0 0 0 0 0 0 2 2 2 2 2 2 2 2 2 0 0 0 0 0 0 0 0 0 0 0 0 0 0 0 0 0 0 0 0 
              0 0 0 0 2 2 2 2 2 2 0 0 0 0 0 0 0 0 0 0 0 0 2 2 2 2 2 2 0 0 0 0 0 0 0 0 0 0 0 0 0 0 0 0 0 0 0 0 
              0 0 0 0 2 2 2 2 2 2 0 0 0 0 0 0 0 0 0 0 0 0 2 2 2 2 2 2 0 0 0 0 0 0 0 0 0 0 0 0 0 0 0 0 0 0 0 0 
              0 0 0 0 2 2 2 2 2 2 0 0 0 0 0 0 0 0 0 0 0 0 2 2 2 2 2 2 0 0 0 0 0 0 0 0 0 0 0 0 0 0 0 0 0 0 0 0 
              0 0 0 0 2 2 2 2 2 2 0 0 0 0 0 0 0 0 0 0 0 0 2 2 2 2 2 2 0 0 0 0 0 0 0 0 0 0 0 0 0 0 0 0 0 0 0 0 
              0 0 0 0 2 2 2 0 0 0 0 0 0 0 0 0 0 0 0 0 0 0 2 2 2 2 2 2 0 0 0 0 0 0 0 0 0 0 0 0 0 0 0 0 0 0 0 0 
              0 0 0 0 2 2 2 0 0 0 0 0 0 0 2 0 2 0 2 0 2 0 2 2 2 2 2 2 0 0 0 0 0 0 0 0 0 0 0 0 0 0 0 0 0 0 0 0 
              0 0 0 0 1 0 0 0 0 0 0 0 0 0 0 0 0 0 0 0 0 0 0 0 0 2 2 2 0 0 0 0 0 0 0 0 0 0 0 0 0 0 0 0 0 0 0 0 
              0 0 0 0 1 0 0 0 0 0 0 0 0 0 0 0 0 0 0 0 0 0 0 0 0 2 2 2 0 0 0 0 0 0 0 0 0 0 0 0 0 0 0 0 0 0 0 0 
              0 0 0 0 1 0 0 0 0 0 0 0 0 0 0 0 0 0 0 0 0 0 0 0 0 2 2 2 0 0 0 0 0 0 0 0 0 0 0 0 0 0 0 0 0 0 0 0 
              0 0 0 0 2 2 2 2 2 2 2 2 2 0 0 0 2 2 2 2 2 2 2 2 2 2 2 2 0 0 0 0 0 0 0 0 0 0 0 0 0 0 0 0 0 0 0 0 
              0 0 0 0 2 2 2 2 2 2 2 2 2 0 0 0 2 2 2 2 2 2 2 2 2 2 2 2 0 0 0 0 0 0 0 0 0 0 0 0 0 0 0 0 0 0 0 0 
              0 0 0 0 2 2 2 2 2 2 2 2 2 1 1 1 2 2 2 2 2 2 2 2 2 2 2 2 0 0 0 0 0 0 0 0 0 0 0 0 0 0 0 0 0 0 0 0 
              0 0 0 0 0 0 0 0 0 0 0 0 0 0 0 0 0 0 0 0 0 0 0 0 0 0 0 0 0 0 0 0 0 0 0 0 0 0 0 0 0 0 0 0 0 0 0 0 
              0 0 0 0 0 0 0 0 0 0 0 0 0 0 0 0 0 0 0 0 0 0 0 0 0 0 0 0 0 0 0 0 0 0 0 0 0 0 0 0 0 0 0 0 0 0 0 0 
			</cellElevations>

			<passableCells>
              0 0 0 0 0 0 0 0 0 0 0 0 0 0 0 0 0 0 0 0 0 0 0 0 0 0 0 0 0 0 0 0 0 0 0 0 0 0 0 0 0 0 0 0 0 0 0 0 
              0 0 0 0 0 0 0 0 0 0 0 0 0 0 0 0 0 0 0 0 0 0 0 0 0 0 0 0 0 0 0 0 0 0 0 0 0 0 0 0 0 0 0 0 0 0 0 0 
              0 0 0 0 0 0 0 0 0 0 0 0 0 0 0 0 0 0 0 0 0 0 0 0 0 0 0 0 0 0 0 0 0 0 0 0 0 0 0 0 0 0 0 0 0 0 0 0 
              0 0 0 0 0 0 0 0 0 0 0 0 0 0 0 0 0 0 0 0 0 0 0 0 0 0 0 0 0 0 0 0 0 0 0 0 0 0 0 0 0 0 0 0 0 0 0 0 
              0 0 0 0 0 0 0 0 0 0 0 0 0 0 0 0 0 0 0 0 0 0 0 0 0 0 0 0 0 0 0 0 0 0 0 0 0 0 0 0 0 0 0 0 0 0 0 0 
              0 0 0 0 0 0 0 0 0 0 0 0 0 0 0 0 0 0 0 0 0 0 0 0 0 0 0 0 0 0 0 0 0 0 0 0 0 0 0 0 0 0 0 0 0 0 0 0 
              0 0 0 0 0 0 0 0 0 0 0 0 0 0 0 0 0 0 0 0 0 0 0 0 0 0 0 0 0 0 0 0 0 0 0 0 0 0 0 0 0 0 0 0 0 0 0 0 
              0 0 0 0 0 0 0 0 0 0 0 0 0 0 0 0 0 0 0 0 0 0 0 0 0 0 0 0 0 0 0 0 0 0 0 0 0 0 0 0 0 0 0 0 0 0 0 0 
              0 0 0 0 0 0 0 0 0 0 0 0 0 0 0 0 0 0 0 0 0 0 0 0 0 0 0 0 0 0 0 0 0 0 0 0 0 0 0 0 0 0 0 0 0 0 0 0 
              0 0 0 0 0 0 0 0 0 0 0 0 0 0 0 0 0 0 0 0 0 0 0 0 0 0 0 0 0 0 0 0 0 0 0 0 0 0 0 0 0 0 0 0 0 0 0 0 
              0 0 0 0 0 0 0 0 0 0 0 0 0 0 0 0 0 0 0 0 0 0 0 0 0 0 0 0 0 0 0 0 0 0 0 0 0 0 0 0 0 0 0 0 0 0 0 0 
              0 0 0 0 0 0 0 0 0 0 0 0 0 0 0 0 0 0 0 0 0 0 0 0 0 0 0 0 0 0 0 0 0 0 0 0 0 0 0 0 0 0 0 0 0 0 0 0 
              0 0 0 0 0 0 0 0 0 0 0 0 0 0 0 0 0 0 0 0 0 0 0 0 0 0 0 0 0 0 0 0 0 0 0 0 0 0 0 0 0 0 0 0 0 0 0 0 
              0 0 0 0 0 0 0 0 0 0 0 0 0 0 0 0 0 0 0 0 0 0 0 0 0 0 0 0 0 0 0 0 0 0 0 0 0 0 0 0 0 0 0 0 0 0 0 0 
              0 0 0 0 0 0 0 0 0 0 0 0 0 0 0 0 0 0 0 0 0 0 0 0 0 0 0 0 0 0 0 0 0 0 0 0 0 0 0 0 0 0 0 0 0 0 0 0 
              0 0 0 0 0 0 0 0 0 0 0 0 0 0 0 0 0 0 0 0 0 0 0 0 0 0 0 0 0 0 0 0 0 0 0 0 0 0 0 0 0 0 0 0 0 0 0 0 
              0 0 0 0 0 0 0 0 0 0 0 0 0 0 0 0 0 0 0 0 0 0 0 0 0 0 0 0 0 0 0 0 0 0 0 0 0 0 0 0 0 0 0 0 0 0 0 0 
              0 0 0 0 0 0 0 0 0 0 0 0 0 0 0 0 0 0 0 0 0 0 0 0 0 0 0 0 0 0 0 0 0 0 0 0 0 0 0 0 0 0 0 0 0 0 0 0 
              0 0 0 0 0 0 0 0 0 0 0 0 0 0 0 0 1 1 1 0 0 0 0 0 0 0 0 0 0 0 0 0 0 0 0 0 0 0 0 0 0 0 0 0 0 0 0 0 
              0 0 0 0 0 0 0 0 0 0 0 0 0 0 0 0 1 1 1 0 0 0 0 0 0 0 0 0 0 0 0 0 0 0 0 0 0 0 0 0 0 0 0 0 0 0 0 0 
              0 0 0 0 0 0 0 0 0 0 0 0 0 0 0 0 1 1 1 0 0 0 0 0 0 0 0 0 0 0 0 0 0 0 0 0 0 0 0 0 0 0 0 0 0 0 0 0 
              0 0 0 0 0 0 0 0 0 0 0 0 0 0 0 0 1 1 1 0 0 0 0 0 0 0 0 0 0 0 0 0 0 0 0 0 0 0 0 0 0 0 0 0 0 0 0 0 
              0 0 0 0 0 0 0 0 0 0 0 0 0 0 0 0 1 1 1 0 0 0 0 0 0 0 0 0 0 0 0 0 0 0 0 0 0 0 0 0 0 0 0 0 0 0 0 0 
              0 0 0 0 0 0 0 0 0 0 1 1 1 1 1 0 1 1 1 1 1 1 1 1 1 0 0 0 0 0 0 0 0 0 0 0 0 0 0 0 0 0 0 0 0 0 0 0 
              0 0 0 0 0 0 0 0 0 0 1 1 1 1 1 1 1 1 1 1 1 1 1 1 1 0 0 0 0 0 0 0 0 0 0 0 0 0 0 0 0 0 0 0 0 0 0 0 
              0 0 0 0 0 0 0 0 0 0 1 1 1 1 1 1 1 1 1 1 1 1 1 1 1 0 0 0 0 0 0 0 0 0 0 0 0 0 0 0 0 0 0 0 0 0 0 0 
              0 0 0 0 0 0 0 0 0 0 1 1 1 1 1 1 1 1 1 1 1 1 1 1 1 0 0 0 0 0 0 0 0 0 0 0 0 0 0 0 0 0 0 0 0 0 0 0 
              0 0 0 0 0 0 0 0 0 0 0 0 0 0 0 0 0 0 0 0 0 0 1 1 1 0 0 0 0 0 0 0 0 0 0 0 0 0 0 0 0 0 0 0 0 0 0 0 
              0 0 0 0 0 0 0 0 0 0 0 0 0 0 0 0 0 0 0 0 0 0 1 1 1 0 0 0 0 0 0 0 0 0 0 0 0 0 0 0 0 0 0 0 0 0 0 0 
              0 0 0 0 0 0 0 0 0 0 0 0 0 0 0 0 0 0 0 0 0 0 1 1 1 0 0 0 0 0 0 0 0 0 0 0 0 0 0 0 0 0 0 0 0 0 0 0 
              0 0 0 0 0 0 0 1 1 1 1 1 1 1 0 1 0 1 0 1 0 1 1 1 1 0 0 0 0 0 0 0 0 0 0 0 0 0 0 0 0 0 0 0 0 0 0 0 
              0 0 0 0 0 0 0 1 1 1 1 1 1 1 1 1 1 1 1 1 1 1 1 1 1 0 0 0 0 0 0 0 0 0 0 0 0 0 0 0 0 0 0 0 0 0 0 0 
              0 0 0 0 0 1 1 1 1 1 1 1 1 1 1 1 1 1 1 1 1 1 1 1 1 0 0 0 0 0 0 0 0 0 0 0 0 0 0 0 0 0 0 0 0 0 0 0 
              0 0 0 0 0 0 0 0 0 0 0 0 0 1 1 1 0 0 0 0 0 0 0 0 0 0 0 0 0 0 0 0 0 0 0 0 0 0 0 0 0 0 0 0 0 0 0 0 
              0 0 0 0 0 0 0 0 0 0 0 0 0 1 1 1 0 0 0 0 0 0 0 0 0 0 0 0 0 0 0 0 0 0 0 0 0 0 0 0 0 0 0 0 0 0 0 0 
              0 0 0 0 0 0 0 0 0 0 0 0 0 1 1 1 0 0 0 0 0 0 0 0 0 0 0 0 0 0 0 0 0 0 0 0 0 0 0 0 0 0 0 0 0 0 0 0 
              0 0 0 0 0 0 0 0 0 0 0 0 0 1 1 1 0 0 0 0 0 0 0 0 0 0 0 0 0 0 0 0 0 0 0 0 0 0 0 0 0 0 0 0 0 0 0 0 
              0 0 0 0 0 0 0 0 0 0 0 0 0 0 0 0 0 0 0 0 0 0 0 0 0 0 0 0 0 0 0 0 0 0 0 0 0 0 0 0 0 0 0 0 0 0 0 0 
              0 0 0 0 0 0 0 0 0 0 0 0 0 1 1 1 0 0 0 0 0 0 0 0 0 0 0 0 0 0 0 0 0 0 0 0 0 0 0 0 0 0 0 0 0 0 0 0 
              0 0 0 0 0 0 0 0 0 0 0 0 0 0 0 0 0 0 0 0 0 0 0 0 0 0 0 0 0 0 0 0 0 0 0 0 0 0 0 0 0 0 0 0 0 0 0 0 
			</passableCells>

			<visibleCells>
              1 1 1 1 1 1 1 1 1 1 1 1 1 1 1 1 1 1 1 1 1 1 1 1 1 1 1 1 1 1 1 1 1 1 1 1 1 1 1 1 1 1 1 1 1 1 1 1 
              1 1 1 1 1 1 1 1 1 1 1 1 1 1 1 1 1 1 1 1 1 1 1 1 1 1 1 1 1 1 1 1 1 1 1 1 1 1 1 1 1 1 1 1 1 1 1 1 
              1 1 1 1 1 1 1 1 1 1 1 1 1 1 1 1 1 1 1 1 1 1 1 1 1 1 1 1 1 1 1 1 1 1 1 1 1 1 1 1 1 1 1 1 1 1 1 1 
              1 1 1 1 1 1 1 1 1 1 1 1 1 1 1 1 1 1 1 1 1 1 1 1 1 1 1 1 1 1 1 1 1 1 1 1 1 1 1 1 1 1 1 1 1 1 1 1 
              1 1 1 1 1 1 1 1 1 1 1 1 1 1 1 1 1 1 1 1 1 1 1 1 1 1 1 1 1 1 1 1 1 1 1 1 1 1 1 1 1 1 1 1 1 1 1 1 
              1 1 1 1 1 1 1 1 1 1 1 1 1 1 1 1 1 1 1 1 1 1 1 1 1 1 1 1 1 1 1 1 1 1 1 1 1 1 1 1 1 1 1 1 1 1 1 1 
              1 1 1 1 1 1 1 1 1 1 1 1 1 1 1 1 1 1 1 1 1 1 1 1 1 1 1 1 1 1 1 1 1 1 1 1 1 1 1 1 1 1 1 1 1 1 1 1 
              1 1 1 1 1 1 1 1 1 1 1 1 1 1 1 1 1 1 1 1 1 1 1 1 1 1 1 1 1 1 1 1 1 1 1 1 1 1 1 1 1 1 1 1 1 1 1 1 
              1 1 1 1 1 1 1 1 1 1 1 1 1 1 1 1 1 1 1 1 1 1 1 1 1 1 1 1 1 1 1 1 1 1 1 1 1 1 1 1 1 1 1 1 1 1 1 1 
              1 1 1 1 1 1 1 1 1 1 1 1 1 1 1 1 1 1 1 1 1 1 1 1 1 1 1 1 1 1 1 1 1 1 1 1 1 1 1 1 1 1 1 1 1 1 1 1 
              1 1 1 1 1 1 1 1 1 1 1 1 1 1 1 1 1 1 1 1 1 1 1 1 1 1 1 1 1 1 1 1 1 1 1 1 1 1 1 1 1 1 1 1 1 1 1 1 
              1 1 1 1 1 1 1 1 1 1 1 1 1 1 1 1 1 1 1 1 1 1 1 1 1 1 1 1 1 1 1 1 1 1 1 1 1 1 1 1 1 1 1 1 1 1 1 1 
              1 1 1 1 1 1 1 1 1 1 1 1 1 1 1 1 1 1 1 1 1 1 1 1 1 1 1 1 1 1 1 1 1 1 1 1 1 1 1 1 1 1 1 1 1 1 1 1 
              1 1 1 1 1 1 1 1 1 1 1 1 1 1 1 1 1 1 1 1 1 1 1 1 1 1 1 1 1 1 1 1 1 1 1 1 1 1 1 1 1 1 1 1 1 1 1 1 
              1 1 1 1 1 1 1 1 1 1 1 1 1 1 1 1 1 1 1 1 1 1 1 1 1 1 1 1 1 1 1 1 1 1 1 1 1 1 1 1 1 1 1 1 1 1 1 1 
              1 1 1 1 1 1 1 1 1 1 1 1 1 1 1 1 1 1 1 1 1 1 1 1 1 1 1 1 1 1 1 1 1 1 1 1 1 1 1 1 1 1 1 1 1 1 1 1 
              1 1 1 1 0 0 0 0 0 0 0 0 0 0 0 0 1 1 1 0 0 0 0 0 0 0 0 0 1 1 1 1 1 1 1 1 1 1 1 1 1 1 1 1 1 1 1 1 
              1 1 1 1 0 0 0 0 0 0 0 0 0 0 0 0 1 1 1 0 0 0 0 0 0 0 0 0 1 1 1 1 1 1 1 1 1 1 1 1 1 1 1 1 1 1 1 1 
              1 1 1 1 0 0 0 0 0 0 0 0 0 0 0 0 1 1 1 0 0 0 0 0 0 0 0 0 1 1 1 1 1 1 1 1 1 1 1 1 1 1 1 1 1 1 1 1 
              1 1 1 1 0 0 0 0 0 0 0 0 0 0 0 0 1 1 1 0 0 0 0 0 0 0 0 0 1 1 1 1 1 1 1 1 1 1 1 1 1 1 1 1 1 1 1 1 
              1 1 1 1 0 0 0 0 0 0 0 0 0 0 0 0 1 1 1 0 0 0 0 0 0 0 0 0 1 1 1 1 1 1 1 1 1 1 1 1 1 1 1 1 1 1 1 1 
              1 1 1 1 0 0 0 0 0 0 0 0 0 0 0 0 1 1 1 0 0 0 0 0 0 0 0 0 1 1 1 1 1 1 1 1 1 1 1 1 1 1 1 1 1 1 1 1 
              1 1 1 1 0 0 0 0 0 0 0 0 0 0 0 0 1 1 1 0 0 0 0 0 0 0 0 0 1 1 1 1 1 1 1 1 1 1 1 1 1 1 1 1 1 1 1 1 
              1 1 1 1 0 0 0 0 0 0 1 1 1 1 1 1 1 1 1 1 1 1 1 1 1 0 0 0 1 1 1 1 1 1 1 1 1 1 1 1 1 1 1 1 1 1 1 1 
              1 1 1 1 0 0 0 1 1 1 1 1 1 1 1 1 1 1 1 1 1 1 1 1 1 0 0 0 1 1 1 1 1 1 1 1 1 1 1 1 1 1 1 1 1 1 1 1 
              1 1 1 1 0 0 0 1 1 1 1 1 1 1 1 1 1 1 1 1 1 1 1 1 1 0 0 0 1 1 1 1 1 1 1 1 1 1 1 1 1 1 1 1 1 1 1 1 
              1 1 1 1 0 0 0 1 1 1 1 1 1 1 1 1 1 1 1 1 1 1 1 1 1 0 0 0 1 1 1 1 1 1 1 1 1 1 1 1 1 1 1 1 1 1 1 1 
              1 1 1 1 0 0 0 1 1 1 1 1 1 1 1 1 1 1 1 1 1 1 1 1 1 0 0 0 1 1 1 1 1 1 1 1 1 1 1 1 1 1 1 1 1 1 1 1 
              1 1 1 1 0 0 0 1 1 1 1 1 1 1 1 1 0 1 0 1 1 1 1 1 1 0 0 0 1 1 1 1 1 1 1 1 1 1 1 1 1 1 1 1 1 1 1 1 
              1 1 1 1 0 0 0 1 1 1 1 1 1 1 0 1 0 0 0 1 0 1 1 1 1 0 0 0 1 1 1 1 1 1 1 1 1 1 1 1 1 1 1 1 1 1 1 1 
              1 1 1 1 0 0 0 1 1 1 1 1 1 1 0 1 0 1 0 1 0 1 1 1 1 0 0 0 1 1 1 1 1 1 1 1 1 1 1 1 1 1 1 1 1 1 1 1 
              1 1 1 1 0 0 0 1 1 1 1 1 1 1 1 1 1 1 1 1 1 1 1 1 1 0 0 0 1 1 1 1 1 1 1 1 1 1 1 1 1 1 1 1 1 1 1 1 
              1 1 1 1 1 1 1 1 1 1 1 1 1 1 1 1 1 1 1 1 1 1 1 1 1 0 0 0 1 1 1 1 1 1 1 1 1 1 1 1 1 1 1 1 1 1 1 1 
              1 1 1 1 1 0 0 0 0 0 0 0 0 1 1 1 0 0 0 0 0 0 0 0 0 0 0 0 1 1 1 1 1 1 1 1 1 1 1 1 1 1 1 1 1 1 1 1 
              1 1 1 1 0 0 0 0 0 0 0 0 0 1 1 1 0 0 0 0 0 0 0 0 0 0 0 0 1 1 1 1 1 1 1 1 1 1 1 1 1 1 1 1 1 1 1 1 
              1 1 1 1 1 1 1 1 1 1 1 1 1 1 1 1 1 1 1 1 1 1 1 1 1 0 0 0 1 1 1 1 1 1 1 1 1 1 1 1 1 1 1 1 1 1 1 1 
              1 1 1 1 1 1 1 1 1 1 1 1 1 1 1 1 1 1 1 1 1 1 1 1 1 0 0 0 1 1 1 1 1 1 1 1 1 1 1 1 1 1 1 1 1 1 1 1 
              1 1 1 1 1 1 1 1 1 1 1 1 1 1 1 1 1 1 1 1 1 1 1 1 1 0 0 0 1 1 1 1 1 1 1 1 1 1 1 1 1 1 1 1 1 1 1 1 
              1 1 1 1 1 1 1 1 1 1 1 1 1 1 1 1 1 1 1 1 1 1 1 1 1 1 1 1 1 1 1 1 1 1 1 1 1 1 1 1 1 1 1 1 1 1 1 1 
              1 1 1 1 1 1 1 1 1 1 1 1 1 1 1 1 1 1 1 1 1 1 1 1 1 1 1 1 1 1 1 1 1 1 1 1 1 1 1 1 1 1 1 1 1 1 1 1 
			</visibleCells>
      </cellData>

      <roomData>
          <room x="9" z="7" width="17" height="11">
          </room>
      </roomData>
  </grid>

  <static>
		<staticObject id="28148" prefab="SD_Column_01" x="15" y="0.0" z="16" width="1" height="1" rotation="180">
      </staticObject>
		<staticObject id="27770" prefab="SD_Hedge_Straight_01" x="4" y="0.0" z="7" width="1" height="1" rotation="180">
      </staticObject>
		<staticObject id="26670" prefab="SD_Hedge_Straight_01" x="13" y="0.0" z="2" width="1" height="1" rotation="90">
      </staticObject>
		<staticObject id="28910" prefab="SD_Hedge_Straight_01" x="4" y="0.0" z="5" width="1" height="1" rotation="180">
      </staticObject>
		<staticObject id="28402" prefab="SD_Hedge_Straight_01" x="15" y="0.0" z="2" width="1" height="1" rotation="90">
      </staticObject>
		<staticObject id="29486" prefab="SD_Hedge_Straight_01" x="4" y="0.0" z="6" width="1" height="1" rotation="180">
      </staticObject>
		<staticObject id="29112" prefab="SD_Hedge_Straight_01" x="14" y="0.0" z="2" width="1" height="1" rotation="90">
      </staticObject>
		<staticObject id="27828" prefab="SD_MedWall_Standalone_01" x="18" y="0.0" z="8" width="1" height="1" rotation="180">
      </staticObject>
		<staticObject id="28106" prefab="SD_MedWall_Standalone_01" x="20" y="0.0" z="8" width="1" height="1" rotation="180">
      </staticObject>
		<staticObject id="28862" prefab="SD_MedWall_Standalone_01" x="14" y="0.0" z="8" width="1" height="1" rotation="180">
      </staticObject>
		<staticObject id="28362" prefab="SD_MedWall_Standalone_01" x="16" y="0.0" z="8" width="1" height="1" rotation="180">
      </staticObject>
		<staticObject id="27168" prefab="SD_Short_House_End_01" x="7" y="0.0" z="13" width="3" height="3" rotation="270">
      </staticObject>
		<staticObject id="27300" prefab="SD_Short_House_End_01" x="7" y="0.0" z="10" width="3" height="3" rotation="90">
      </staticObject>
		<staticObject id="29372" prefab="SD_Short_House_End_01" x="4" y="0.0" z="2" width="3" height="3" rotation="0">
      </staticObject>
		<staticObject id="26906" prefab="SD_Short_House_End_01" x="10" y="0.0" z="2" width="3" height="3" rotation="180">
      </staticObject>
		<staticObject id="26984" prefab="SD_Short_House_End_01" x="16" y="0.0" z="2" width="3" height="3" rotation="0">
      </staticObject>
		<staticObject id="28052" prefab="SD_Short_House_Straight_01" x="22" y="0.0" z="2" width="3" height="3" rotation="180">
      </staticObject>
		<staticObject id="26918" prefab="SD_Short_House_Straight_01" x="19" y="0.0" z="2" width="3" height="3" rotation="180">
      </staticObject>
		<staticObject id="27684" prefab="SD_Short_House_Straight_01" x="7" y="0.0" z="2" width="3" height="3" rotation="180">
      </staticObject>
		<staticObject id="27850" prefab="SD_Tall_House_Corner_01" x="25" y="0.0" z="17" width="3" height="3" rotation="0">
      </staticObject>
		<staticObject id="27888" prefab="SD_Tall_House_Corner_01" x="4" y="0.0" z="17" width="3" height="3" rotation="90">
      </staticObject>
		<staticObject id="28248" prefab="SD_Tall_House_End_01" x="25" y="0.0" z="2" width="3" height="3" rotation="90">
      </staticObject>
		<staticObject id="27566" prefab="SD_Tall_House_End_01" x="4" y="0.0" z="8" width="3" height="3" rotation="90">
      </staticObject>
		<staticObject id="29490" prefab="SD_Tall_House_End_01" x="13" y="0.0" z="17" width="3" height="3" rotation="180">
      </staticObject>
		<staticObject id="29276" prefab="SD_Tall_House_End_01" x="19" y="0.0" z="17" width="3" height="3" rotation="0">
      </staticObject>
		<staticObject id="28672" prefab="SD_Tall_House_Straight_01" x="25" y="0.0" z="8" width="3" height="3" rotation="90">
      </staticObject>
		<staticObject id="27606" prefab="SD_Tall_House_Straight_01" x="25" y="0.0" z="11" width="3" height="3" rotation="90">
      </staticObject>
		<staticObject id="29164" prefab="SD_Tall_House_Straight_01" x="25" y="0.0" z="14" width="3" height="3" rotation="90">
      </staticObject>
		<staticObject id="27690" prefab="SD_Tall_House_Straight_01" x="4" y="0.0" z="11" width="3" height="3" rotation="90">
      </staticObject>
		<staticObject id="26936" prefab="SD_Tall_House_Straight_01" x="7" y="0.0" z="17" width="3" height="3" rotation="180">
      </staticObject>
		<staticObject id="26826" prefab="SD_Tall_House_Straight_01" x="22" y="0.0" z="17" width="3" height="3" rotation="180">
      </staticObject>
		<staticObject id="27274" prefab="SD_Tall_House_Straight_01" x="25" y="0.0" z="5" width="3" height="3" rotation="90">
      </staticObject>
		<staticObject id="28156" prefab="SD_Tall_House_Straight_01" x="10" y="0.0" z="17" width="3" height="3" rotation="180">
      </staticObject>
		<staticObject id="28222" prefab="SD_Tall_House_Straight_01" x="4" y="0.0" z="14" width="3" height="3" rotation="90">
      </staticObject>
		<staticObject id="27832" prefab="SD_Tall_Terrace_End_01" x="22" y="0.0" z="8" width="3" height="3" rotation="90">
      </staticObject>
		<staticObject id="28152" prefab="SD_Tall_Terrace_End_01" x="19" y="0.0" z="14" width="3" height="3" rotation="0">
      </staticObject>
		<staticObject id="29472" prefab="SD_Tall_Terrace_Straight_01" x="22" y="0.0" z="14" width="3" height="3" rotation="90">
      </staticObject>
		<staticObject id="28530" prefab="SD_Tall_Terrace_Straight_01" x="22" y="0.0" z="11" width="3" height="3" rotation="90">
      </staticObject>
		<staticObject id="29294" prefab="SD_Chasm_1x3_01" x="19" y="0.0" z="10" width="3" height="1" rotation="0">
      </staticObject>
		<staticObject id="26902" prefab="SD_Chasm_1x3_01" x="19" y="0.0" z="12" width="3" height="1" rotation="180">
      </staticObject>
		<staticObject id="26914" prefab="SD_Chasm_1x3_01" x="10" y="0.0" z="10" width="1" height="3" rotation="270">
      </staticObject>
		<staticObject id="27376" prefab="SD_Chasm_1x3_01" x="21" y="0.0" z="10" width="1" height="3" rotation="90">
      </staticObject>
		<staticObject id="28540" prefab="SD_Chasm_1x9_01" x="10" y="0.0" z="10" width="9" height="1" rotation="0">
      </staticObject>
		<staticObject id="26872" prefab="SD_Chasm_1x9_01" x="7" y="0.0" z="12" width="9" height="1" rotation="180">
      </staticObject>
		<staticObject id="28238" prefab="SD_Floor_Grass_1x2_01" x="25" y="0.0" z="7" width="1" height="2" rotation="90">
      </staticObject>
		<staticObject id="29616" prefab="SD_Floor_Grass_1x3_01" x="19" y="0.0" z="13" width="3" height="1" rotation="180">
      </staticObject>
		<staticObject id="29158" prefab="SD_Floor_Grass_1x5_01" x="20" y="0.0" z="8" width="5" height="1" rotation="180">
      </staticObject>
		<staticObject id="26714" prefab="SD_Floor_Grass_1x5_01" x="15" y="0.0" z="13" width="1" height="5" rotation="90">
      </staticObject>
		<staticObject id="27232" prefab="SD_Floor_Grass_1x5_01" x="14" y="0.0" z="13" width="1" height="5" rotation="90">
      </staticObject>
		<staticObject id="29154" prefab="SD_Floor_Grass_1x5_01" x="20" y="0.0" z="7" width="5" height="1" rotation="180">
      </staticObject>
		<staticObject id="27008" prefab="SD_Floor_Grass_5x5_01" x="9" y="0.0" z="13" width="5" height="5" rotation="180">
      </staticObject>
		<staticObject id="28704" prefab="SD_Floor_Stone_1x2_01" x="19" y="0.0" z="7" width="1" height="2" rotation="90">
      </staticObject>
		<staticObject id="28128" prefab="SD_Floor_Stone_1x3_01" x="4" y="0.0" z="7" width="3" height="1" rotation="180">
      </staticObject>
		<staticObject id="28824" prefab="SD_Floor_Stone_1x3_01" x="19" y="0.0" z="9" width="3" height="1" rotation="180">
      </staticObject>
		<staticObject id="28232" prefab="SD_Floor_Stone_1x9_01" x="4" y="0.0" z="6" width="9" height="1" rotation="180">
      </staticObject>
		<staticObject id="27558" prefab="SD_Floor_Stone_1x9_01" x="16" y="0.0" z="6" width="9" height="1" rotation="180">
      </staticObject>
		<staticObject id="28426" prefab="SD_Floor_Stone_1x9_01" x="16" y="0.0" z="5" width="9" height="1" rotation="180">
      </staticObject>
		<staticObject id="29514" prefab="SD_Floor_Stone_1x9_01" x="4" y="0.0" z="5" width="9" height="1" rotation="180">
      </staticObject>
		<staticObject id="28514" prefab="SD_Floor_Stone_3x3_01" x="16" y="0.0" z="13" width="3" height="3" rotation="180">
      </staticObject>
		<staticObject id="28880" prefab="SD_Floor_Stone_3x3_01" x="16" y="0.0" z="7" width="3" height="3" rotation="180">
      </staticObject>
		<staticObject id="26922" prefab="SD_Floor_Stone_3x3_01" x="13" y="0.0" z="7" width="3" height="3" rotation="180">
      </staticObject>
		<staticObject id="27754" prefab="SD_Floor_Stone_3x3_01" x="13" y="0.0" z="4" width="3" height="3" rotation="180">
      </staticObject>
		<staticObject id="27562" prefab="SD_Floor_Stone_3x3_01" x="13" y="0.0" z="1" width="3" height="3" rotation="180">
      </staticObject>
		<staticObject id="28218" prefab="SD_Floor_Stone_3x3_01" x="7" y="0.0" z="7" width="3" height="3" rotation="180">
      </staticObject>
		<staticObject id="29216" prefab="SD_Floor_Stone_3x3_01" x="16" y="0.0" z="19" width="3" height="3" rotation="180">
      </staticObject>
		<staticObject id="28544" prefab="SD_Floor_Stone_3x3_01" x="16" y="0.0" z="16" width="3" height="3" rotation="180">
      </staticObject>
	</static>

  <units>
		<playerUnit id="27956" prefab="Assassin" x="19" z="7" rotation="180">
      </playerUnit>
		<playerUnit id="29518" prefab="Thief" x="15" z="7" rotation="180">
      </playerUnit>
  </units>

  <other>
      <dynamicObject id="26790" prefab="GoalZone_Assassin" x="17" y="0" z="17" rotation="180">
      </dynamicObject>
      <dynamicObject id="27782" prefab="GoalZone_Thief" x="17" y="0" z="17" rotation="180">
      </dynamicObject>
      <dynamicObject id="28410" prefab="PressurePlate" x="10" y="0" z="8" rotation="180">
          <component name="Triggerable">
              <property name="SetDecalType">
                  <field>decal_1.png</field>
              </property>
          </component>
      </dynamicObject>
      <dynamicObject id="27544" prefab="PressurePlate" x="12" y="0" z="8" rotation="180">
          <component name="Triggerable">
              <property name="SetDecalType">
                  <field>decal_1.png</field>
              </property>
          </component>
      </dynamicObject>
      <dynamicObject id="27078" prefab="SD_Interactive_Elevator_01" x="11" y="0" z="8" rotation="90">
          <component name="Triggerable">
              <property name="SetDecalType">
                  <field>decal_1.png</field>
              </property>
          </component>
      </dynamicObject>
      <dynamicObject id="28472" prefab="SD_Interactive_Elevator_01" x="17" y="-2" z="11" rotation="180">
          <component name="Triggerable">
              <property name="SetDecalType">
                  <field>decal_2.png</field>
              </property>
          </component>
      </dynamicObject>
      <dynamicObject id="29258" prefab="SD_KeyPad_01" x="20" y="4" z="15" rotation="180">
          <component name="Triggerable">
              <property name="SetDecalType">
                  <field>decal_2.png</field>
              </property>
          </component>
      </dynamicObject>
  </other>

  <links>
      <triggerLink id="27078">
          <switch id="27544">
          </switch>
          <switch id="28410">
          </switch>
      </triggerLink>
      <triggerLink id="28472">
          <switch id="29258">
          </switch>
      </triggerLink>
      <winCondition id="26790">
      </winCondition>
      <winCondition id="27782">
      </winCondition>
  </links>

	<camera focus="Assassin">
      <start x="18" y="26" z="-12.5">
      </start>
      <overview x="15.97837" y="59.97374" z="-13.16934">
      </overview>
	</camera>

	<lightMap name="SD_Playtest2_05_lightmap.png">
	</lightMap>
</level>
